안산 고잔동 냉동삼겹살 냉삼 맛집 '냉삼한상(삼겹포차)' 다녀왔어요~	TRUE
안산 맛집 고잔동 삼겹살 맛집에서 700일 데이트	TRUE
"하남돼지집, 안산 고잔동 삼겹살 맛집"	FALSE
고잔동 삼겹살 맛집 마루야끼 - 솥뚜껑 삼겹살	FALSE
"안산 고잔동 맛집, 중앙역 맛집, 야외 삼겹살 :: 제주도깨비"	FALSE
안산 고잔동 삼겹살 맛집 제주도깨비 나혼자 단골 중	FALSE
안산 고잔동 철판구이 김치 삼겹살 맛집 :: 방철쌈	FALSE
"안산 고잔동 삼겹살 맛집 , 중앙동 맛찬들"	FALSE
안산 고잔동 맛집 강력 추천 고기집 '방철쌈' 대박 삼겹살&갈매기살	TRUE
고잔동 삼겹살 맛집 :: 고잔일미 고깃집	FALSE
안산 고잔동 냉동삼겹살 맛집 총각수퍼	TRUE
[안산 중앙역 고잔동 맛집]레트로 감성의 냉동삼겹살 맛집 ‘총각수퍼’	FALSE
"[고잔동] 제주삼겹살 맛집, 고기 구워주는 안산 “제주도깨비”"	TRUE
안산삼겹살맛집 고잔동 제주도깨비	FALSE
안산 고잔동 고기집 제주삼육돈 흑돼지 삼겹살 맛집 ??	FALSE
안산 삼겹살 맛집 고잔동 하남돼지	TRUE
고잔동삼겹살맛집 일미고깃집 해물냄비가 서비스라니!	FALSE
"[안산/고잔동] 제주의 맛 그대로 가져온 안산고잔동맛집 제주도깨비 리뷰 / 제주특수모듬구이, 제주꽃삼겹살"	FALSE
안산 고잔동 삼겹살 맛집 지리산 흑돼지 쫀맛탱! 청해꺼먹돼지	FALSE
[안산 고잔동] 삼겹살 맛집 하남돼지집 ; 안산회식장소로 딱이야!	FALSE
[안산고잔동삼겹살맛집] 맛나고푸짐한 하남돼지집 ??슬기로운외식생활	FALSE
"고잔동 삼겹살 맛집 [ 하남돼지집 ]삼겹살, 김치말이국수"	TRUE
[일미] 안산고잔동고기집 삼겹살 목살 맛집 술집	FALSE
[안산 고잔동] 하남돼지집 - 구워줘서 더 맛있는 믿고 먹는 안산삼겹살맛집	FALSE
안산 :: 고잔동삼겹살맛집 고잔일미 도톰한 고기한점 ??	FALSE
[안산 고잔동 삼겹살 맛집] 제주삼육돈	FALSE
안산 고잔동 맛집_안산 삼겹살 맛집 최애 데이트코스 추천	FALSE
안산 고잔동 삼겹살 맛집 맛찬들 중앙점 이베리코 플루마 후기	FALSE
"안산 고잔동 맛집 : 쭉삼이네 / 쭈꾸미삼겹살, 돼지갈비 회식하고 왔어요!"	FALSE
고잔동 삼겹살 맛집 : 제주도깨비(제주돼지)	TRUE
안산 고잔동 맛집 삼겹살 추천 [고잔일미 고깃집]	FALSE
안산 고잔동 삼겹살 맛집 김치찌개가 서비스인 상황돈	FALSE
안산 고잔동 맛집 제주도깨비 회식장소 찾는분들 주목! 삼겹살 죽여주는 고깃집 여기 있어요!	FALSE
[안산맛집] 안산 고잔동 맛집 미나리삼겹살 매일고기	FALSE
안산 삼겹살 맛집 왕주먹 고잔동 고깃집	FALSE
"안산 삼겹살 맛집, 고잔동 하남돼지집 메뉴 추천(삼겹살, 목살, 막창)"	FALSE
[안산 맛집] 안산 고잔동 제주 돼지고기 삼겹살 전문 '방철쌈'	TRUE
안산 고잔동 삼겹살 맛집 하남돼지집 먹고온 후기	FALSE
[안산] 고잔동 삼겹살맛집 황금돼지	FALSE
안산 고잔동 삼겹살 맛집  본심	FALSE
"[안산] 고잔동삼겹살맛집, 고잔일미고깃집 (feat. 기본찬부터 통삼겹까지 완벽!)"	FALSE
"안산 고잔동 삼겹살 맛집 추천 :: 제주도깨비 (본삼겹, 천겹살 후기)"	FALSE
고잔동 배달 맛집 삼겹살 맛있는 돈돈한돼지&쭈불쭈불	FALSE
안산 고잔동 인생고기 삼겹살맛집 (제주도깨비)	FALSE
안산 고잔동 맛집 삼겹살 맛있는 술집 :) 하남돼지집	TRUE
안산 고기맛있게구워주는 고잔동삼겹살 맛집 하남돼지집	FALSE
"안산 고잔동 삼겹살집 추천, 최적의 고기두께를 자랑하는 4호선 중앙역 앞 '맛찬들 왕소금구이'"	FALSE
"고잔동 삼겹살 맛집, 고잔일미 고깃집 다녀왔어요~"	FALSE
고잔동 삼겹살 맛집 : 국민돼지 문화광장로 고깃집 2차로 아오모리-먹방민콩이	FALSE
고잔동맛집) 안산고잔동 삼겹살맛집_행복한돼지집	FALSE
안산 고잔동 삼겹살 맛집 짚탄갈비를 가보다!	FALSE
210614_안산고잔동삼겹살맛집_뜯어뜯어	FALSE
191205 안산 회식은 바로 여기서! 고잔동 삼겹살 맛집 일미고깃집 방문 후기	FALSE
안산 고잔동 맛집 방철쌈 김치쌈겹 고기집 인정!	FALSE
#고잔동삼겹살맛집 #고잔일미고깃집 최고	FALSE
고잔동삼겹살맛집 고잔일미 고깃집 회식장소추천!	FALSE
안산 맛집 삼겹살 맛있는고잔동 술집 [하남 돼지집 ??]	FALSE
고잔동삼겹살맛집 고잔일미고깃집 (조개탕이 기본 안주!)	FALSE
안산 고잔동 맛집 (신도시) : 화통삼 삼겹살 ★	FALSE
"안산 회식으로 딱, 고잔동 삼겹살 맛집 고잔일미고깃집"	FALSE
안산맛집고잔동삼겹살고잔일미고깃집추천~^^	FALSE
"안산 고잔동 삼겹살 맛집, 고잔 일미고깃집 넘나 맛있어서 추천"	FALSE
고잔동 삼겹살 맛집 - 일미고깃집	FALSE
고잔동 삼겹살 맛집 좋은소식 가을은 식탐의 계절인가요?	FALSE
"안산 고잔동 맛집, 고잔신도시 삼겹살 고기집은 하남돼지집 강력추천♥"	TRUE
"[안산 고잔동 맛집] 고잔 일미고깃집, 안산 회식은 고잔동 삼겹살 맛집에서!"	FALSE
안산 고잔동 삼겹살 맛집 '고잔일미고깃집' 깔끔해서 좋아!	FALSE
안산 고잔동 삼겹살 맛집 일미고깃집에서 맛있는 한끼	FALSE
안산 고잔동 삼겹살 맛집 일미 고깃집~! 통삼격살 맛있다!!!!!!	FALSE
{안산 맛집} 고잔동 황제돈 / 고잔동 삼겹살 맛집	FALSE
고잔동 삼겹살 맛집 발견 ☆ 고잔일미고깃집	FALSE
고잔동맛집 맛찬들 왕소금구이에서 진짜 맛있는 숙성 삼겹살 먹고 왔어요 _♪	FALSE
[고잔동삼겹살맛집] 삼겹살 소주 조오치~ 안산 고잔동 삽겹살 맛집 '고잔일미고깃집'	FALSE
<안산 고잔동 맛집 / 고기집> 화통삼에서 삼겹살도 먹고 불쇼도 보고	FALSE
[고잔동삼겹살맛집 / 안산삼겹살 ] 고기를 주문하면 전복을 준다!!!? '황제돈'	FALSE
"안산 고잔동 맛집, 행복한돼지집의 맛있는 숙성삼겹살 ♬"	FALSE
[안산 고잔동 맛집] 행복한돼지집에서 삼겹살먹기 ♪	FALSE
"안산 고잔동 맛집, 삼겹살에 육즙이 흐르는 제주도깨비!"	FALSE
고잔동 맛집 삼겹살 고기집 코스로 즐겨봐~~	FALSE
안산 고잔동 맛집 고잔동 삼겹살 하남돼지집 안산고잔점	FALSE
[폐업] 단골 짚풀 볏짚 삼겹살 [안산시고잔동]	FALSE
안산 고잔동 맛집 @ 고잔동 삼겹살 하남돼지집 =)	FALSE
안산 고잔동 고기집 :: 제주도깨비 본삼겹살 & 돈차돌 먹고온 후기!	FALSE
고잔동 맛집 하남돼지집에서 저녁! #고잔동맛집 #고잔동삼겹살	FALSE
"안산고잔동맛집, 삼겹살꽃이 피는 곳 @청춘삼겹살"	FALSE
고잔동맛집-삼겹살과해물의 만남 화통삼	FALSE
[안산 고잔동 맛집] 이젠 너무나 유명한 삼겹살 맛집 화통삼	FALSE
고잔동 맛집 쌈천하에서 맛있는 저녁먹기 #고잔동쌈밥 #고잔동맛집 #삼겹살쌈밥	FALSE
[고잔동맛집]안산삼겹살무한리필 청춘삼겹살에서 두툼한 삼겹살 먹었어요	FALSE
안산 고잔동 삼겹살 '하남돼지집' 맛도 서비스도 최고~!!	FALSE
안산 고잔동 삼겹살은 역시 하남돼지집	FALSE
삼겹살 먹으러 고잔동 황제돈 들렸어요	FALSE
안산 고잔동 맛집 ♪ 황제돈에서 삼겹살 냠냠	FALSE
안산 고잔동 삼겹살 맛집 고잔일미 고깃집	FALSE
고잔동 삼겹살 맛집 <고잔일미고깃집> 一味 인정.	FALSE
안산 고잔동삼겹살맛집 매일고기집	FALSE
안산 고잔동 맛집 삼겹살은 역시 하남돼지집 :)!	FALSE
단언컨대 안산 1등. 고잔동삼겹살맛집 《고잔일미고깃집》	FALSE
고잔동삼겹살맛집 고잔일미고깃집 안산회식장소로도 적격이에요	FALSE
[안산 삼겹살 맛집]고잔동 국민돼지 다녀옴!	FALSE
안산 고잔동 삼겹살 맛집은 무조건 일미고깃집이지!	FALSE
고잔동 삼겹살 맛집	FALSE
안산 고잔동 삼겹살 맛집 고잔일미 다녀오다	FALSE
고잔동 삼겹살 맛집 두툼해서 좋은 고잔일미고깃집	FALSE
[고잔동 삼겹살 맛집] 고잔일미고깃집에서 맛있는 삼겹살 즐기기 ♬	FALSE
안산 고잔동 맛집 미나리삼겹살 '매일고기'	FALSE
"안산 고잔신도시, 고잔동 먹자골목 삼겹살 맛집 #제주도깨비"	TRUE
고잔동삼겹살맛집 1위로 선정한 고잔일미	FALSE
"고잔동 삼겹살 맛집, 일미고깃집의 두툼 삼겹살 보고 가세요!"	FALSE
안산 고잔동 맛집 _ 삼겹살을 푸짐하게 먹을 수 있는 무한리필 삼겹살 무한 삽겹시대!!	TRUE
"안산 고잔동맛집, 청춘삼겹살에서 저녁식사 ♪"	FALSE
안산 고잔동 삼겹살 맛집 고잔일미고깃집	FALSE
"안산삼겹살맛집! 중앙역로데오 고잔동맛집,안산회식장소를 찾으신다면 하남돼지 안산고잔점"	FALSE
안산 고잔동 삼겹살 맛집 고기나라	FALSE
고잔동 삼겹살 맛집 고잔일미고깃집 : 두툼한 통삼겹살과 얼큰한 해물냄비!	FALSE
<안산 회식> 고잔동 삼겹살 맛집 고잔일미고깃집	FALSE
고잔동 삼겹살 맛집 하면 생각나는 고잔일미고깃집	FALSE
고잔동삼겹살맛집 고잔일미고깃집 육즙대박	FALSE
안산 고잔동 삼겹살 맛집♡ '고잔일미 고깃집' 다녀왔어요 :)	FALSE
"안산 삼겹살 맛집, 고잔동 최애고기집이 된 고잔일미고깃집"	FALSE
안산 회식 - 고잔동 삼겹살 맛집은 여기! 일미고깃집	FALSE
삼부자왕돌판 안산삼겹살 고잔동삼겹살맛집	FALSE
안산고잔동맛집 :: 안산회식장소 로 제격인 삼겹살/돼지갈비 맛집 '고기싸롱'	FALSE
[고잔동 맛집] 삼겹살 완전 존맛! 고잔일미고깃집 추천!	FALSE
"안산맛집 추천 :: 고잔동삼겹살맛집 안산회식장소 "" 고잔일미 "" 고기집"	FALSE
안산고잔동맛집:)삼겹살먹으려면 매일고기로~	FALSE
고잔동삼겹살맛집::두툼하고 육즙이 흐르는 삼겹살 맛집▶고잔일미 고깃집◀	FALSE
안산 고잔동 삼겹살 맛집 @ 고잔일미고깃집	FALSE
"쭈꾸미와 삼겹살의 조화! 고잔동맛집 ""돈돈한돼지&쭈불쭈불"""	FALSE
안산 고잔동 맛집 삼겹살맛집은 하남돼지집	FALSE
고잔동삼겹살맛집발견! 고잔일미고깃집	FALSE
안산맛집 고잔동 무한리필 2.8  청춘 삼겹살	FALSE
"고잔동 삼겹살 목살 맛집, “그릴룸”"	FALSE
고잔동 삼겹살 맛집 고잔일미고깃집	FALSE
안산 중앙동 삼겹살 맛집 서울회관 !! 고잔동 가성비 갑 고기집 서울회관	FALSE
안산삼겹살 / 고잔동삼겹살맛집 / 안산삼겹살맛집 '삼부자왕돌판'	TRUE
안산삼겹살맛집 고잔동삼겹살맛집 매일고기 좋아요 !!	FALSE
고잔동삼겹살맛집 매일고기집 숨겨진맛집 발견!	FALSE
안산 삼겹살 맛집 고잔동 삼겹살 단원뒷고기 솔직후기	FALSE
"안산 고잔동 맛집 :: 안산 모임 장소 추천/직장인 회식, 직접 구워주는 삼겹살 맛집 '일미'"	FALSE
[안산 고잔동 삼겹살 맛집] 안산 고잔동 국민돼지 냉동삼겹살 후기	FALSE
고잔동 삼겹살맛집 일미고깃집에서 맛있게 먹은 통삼겹살!	FALSE
고잔동 삼겹살 맛집 일미고깃집에서 생삼겹즐기기	TRUE
안산 회식하기좋은 삼겹살맛집 고잔동 일미고깃집 목살이랑 삼겹살 먹구왔어요 :)	FALSE
안산 고잔동 삼겹살  무한리필맛집 # 여기야 생고기	FALSE
"안산 고잔동 삼겹살 맛집, ""하남돼지집"""	FALSE
"안산 고잔동 삼겹살 맛집, 고잔일미고깃집"	TRUE
"안산 고잔동 삼겹살 맛집,"" 정직한 생고기 ""세상에 이런 맛집은 없었다!"	FALSE
"[★내돈내산 고잔동삼겹살맛집, 고잔일미고깃집★] 푸짐하게 삼겹살과 목살먹고, 조개탕에 칼국수까지!!!"	FALSE
고잔동 삼겹살 맛집 일미고깃집 몇번 가도 최고얏!	FALSE
고잔동삼겹살맛집 매일고기집 진짜로 또 가고 싶은집 !!	FALSE
"[안산맛집] 삼겹살과 목살은 여기가 진리! 고잔동 삼겹살 맛집, 고잔일미고깃집"	FALSE
안산 고잔동 삼겹살맛집 삼부자왕돌판에서 고기먹고왔어요~	FALSE
안산삼겹살맛집 / 고잔동삼겹살맛집 - 매일고기집 삼겹살 + 볶음밥	FALSE
"[안산/고잔] 고잔동삼겹살맛집 고잔일미 - 인테리어도 깔끔, 맛도 깔끔해요."	FALSE
안산 회식은 고잔동 삼겹살 맛집 고잔일미고깃집이 최고야!	FALSE
고잔동삼겹살 맛집 찾았어요! 일미고기집	FALSE
안산삼겹살맛집 고잔동 일미고깃집!	FALSE
고잔동 삼겹살 맛집 :: 고기를 시키면 전복을 준다는 안산 황제돈	FALSE
(안산/고잔동) 삼겹살 맛집	TRUE
고잔동 삼겹살 맛집 _ 고잔일미고깃집 / 안산 삼겹살 맛집	FALSE
고잔동 삼겹살 맛집 고잔일미고깃집 온가족이 맛있게 냠냠	TRUE
"안산 고잔동 삼겹살맛집 ""더 로스트"" 꽃삼겹으로 먹먹 햇어옅"	FALSE
"안산 고잔동 맛집 제주도 토종 돼지전문 백팔번집. 삼겹살, 오겹살 끝내줌."	FALSE
(안산 삼겹살 맛집 : 고잔일미고깃집)고잔동 삼겹살 맛집으로! 안산 회식 많이 하는 곳!	FALSE
"매일고기집_안산 삼겹살 맛집, 고잔동 고기집, 초벌구이 추천"	FALSE
안산 고잔동 삼겹살 맛집 고잔일미고깃집 !	FALSE
고잔동 삼겹살 맛집 고잔일미고깃집 자꾸 생각나	FALSE
맛집) 안산 무한리필을 찾는다면! 고잔동 삼겹살 무한리필 추천 - 고기싸롱 고잔점	TRUE
"[안산 맛집] 기분이 저기압일 땐, 고기 앞으로!! 고잔동 삼겹살 맛집 제주도깨비??"	FALSE
고잔동 삼겹살 맛집 고잔일미고깃집	TRUE
[양푼이 생갈비 김치찌개] 안산 고잔동 삼겹살 숨은 맛집 | 내돈내산 맛집 리뷰	FALSE
"고잔신도시 맛집, 고잔동 삼겹살 맛집, 안산 회식장소 추천 '고잔일미고깃집'"	FALSE
고잔동 삼겹살 맛집 삼부자왕돌판구이	FALSE
안산/고잔동맛집 :: 고잔동 삼겹살 하남돼지집 최고!	FALSE
안산 고잔동 맛집 쭈꾸미도사 반하는 맛	FALSE
[안산고잔동고기집]일미고깃집 내부독특하고 안산삼겹살맛집	FALSE
안산 고잔동 삼겹살맛집 회식장소추천 '상황돈'	FALSE
"[안산 고잔동] 해물 나베와 장아찌가 기본 반찬인 삼겹살 맛집, 고잔 일미 고깃집"	FALSE
[짚탄갈비] 안산 고잔동 고깃집. 삼겹살 맛집.	FALSE
"안산 회식,고잔동 삼겹살 맛집,안산 삼겹살 맛집:"	FALSE
"고잔동맛집 고기싸롱! 품질좋은고기가 무한리필! 갈비맛집, 삼겹살맛집, 안산 고잔동 고기뷔페 고기싸롱"	FALSE
"[고잔동 삼겹살 맛집] 고잔일미고깃집 - 전부 맛있는 존맛집, 안산 회식 장소 추천!"	TRUE
[고잔동맛집] 안산 삼겹살 가성비 한우 맛집 :: 토종한우정육식당	FALSE
안산 고잔동 삼겹살 맛집 정직한 생고기	FALSE
[안산] 고잔동 삼겹살 맛집 “고잔일미고깃집”	TRUE
솔직한리뷰 안산 고잔동맛집 일미집에서 삼겹살 목살을 먹어보았다	FALSE
안산 고잔동 삼겹살 맛집 방철쌈 추천	FALSE
안산 고잔동 맛집 본심 목갈비 꽃갈비 내돈내산	FALSE
안산 고잔동 삼겹살 맛집 고잔일미고깃집	FALSE
고잔동삼겹살맛집]안산맛집 고잔동삼겹살배달 직화구이 미친돼지 예대점	FALSE
고잔동 삼겹살 맛집 고기가 남다른 고잔일미고깃집	FALSE
안산 고잔동삼겹살 맛집) 한돈 삼겹살 단체석이있고 한돈이라 믿고 먹는 - 삼부자왕돌판??	FALSE
"안산 회식, 고잔동 삼겹살 맛집 드디어 예약하고 가본 고잔일미고깃집~"	FALSE
고잔동 삼겹살 맛집_ 고잔일미고깃집 회식장소로 딱!!	FALSE
안산 고잔동 고기집 삼겹살 맛집 맛찬들 최고	FALSE
"[2스타] 고잔동 숙성삼겹살 맛집 고기원칙 내돈내산, 추천할만한 삼겹살 맛집답네!"	FALSE
안산 고잔동 맛집 - 고잔역 가면 꼭 가야하는 핫플레이스 고기집 추천	TRUE
[맛집14탄] 안산맛집(삼겹살)일미고깃집(in고잔동)_그라치아캔들	TRUE
고잔동 삼겹살맛집 황제돈에 다녀왔어요~!! 삼겹살은 언제먹어도 최고인거같아요	FALSE
고잔동 삼겹살 맛집/황제돈/전복은 서비스	FALSE
고잔동 삼겹살 맛집 〔일미고깃집〕 안산 회식 장소 추천	FALSE
안산 고잔동 삼겹살 맛집 <고잔일미고깃집> 회식장소로 딱!	FALSE
안산 고잔동 삼겹살 맛집! <황제돈> 암돼지전문!! 전복은 서비스!^^	FALSE
안산 고잔동 삼겹살 정직한생고기에서 한우한돈셋트 맛나게 먹은 솔직후기!! (안산맛집/고잔역맛집)	FALSE
안산 고잔동 맛집 김치 삼겹살 조합 미쳤다리 양푼이생갈비김치찌개	FALSE
"[그릴룸] 중앙동 삼겹살 맛집, 고잔동 삼겹살 맛집"	FALSE
고잔동 고기집 제주도깨비 삼겹살 굿	FALSE
안산 고잔동 맛집 핫플레이스 추천 제주도깨비에서 본삼겹살 박살!!	TRUE
안산 고잔동 목살 삼겹살 맛집 안산시청 고깃집 #그릴룸 :D	FALSE
안산 고잔동 삼겹살 맛집소개	FALSE
안산 고잔동 맛집 하남돼지집 삼겹살 진리 그 자체 ♬	FALSE
안산 고잔동 삼겹살 / 진지하게 맛있는 맛찬들 안산중앙점	FALSE
고잔동맛집 제주도깨비 특모듬구이 A세트 먹고 왔어요	FALSE
안산삼겹살맛집! 고잔동 하남돼지집 +ㅁ+  안산 회식장소로도 딱입니다!	FALSE
"고잔동 삼겹살 배달, 안산배달맛집 고돼지 안산한양대점"	FALSE
"[안산 고잔동 맛집] 하남돼지집 : 말해뭐해, 모임장소&회식으로 적격!  삼겹살JMT"	FALSE
"고잔동 삼겹살 맛집 일미고깃집, 안산 회식장소로 추천하는 돼지고기 전문점"	FALSE
안산 고잔동 삼겹살 맛집 * 대부축산	FALSE
안산고잔동맛집 고기싸롱 삼겹살 무한리필 사랑이오.	FALSE
"안산 고잔동, 서울예대 고깃집 : 훈이네 꿀돼지갈비 콩나물 삼겹살"	FALSE
[고잔동 삼겹살 맛집]안산 삼겹살 맛집 안산 회식장소 고잔일미고깃집	FALSE
[안산 고잔동 맛집] 삼겹살 무한리필은 뭐다? '고기싸롱' 이다~	FALSE
고잔동 삼겹살맛집!!!! 껍데기도주고 파인애플도주고 다줘뻐리는!! 제주돈고집ㅎㅎ	FALSE
안산 고잔동 맛집 방철쌈 짱 맛있어!	FALSE
풍요로운 안산 고잔동 맛집	FALSE
고잔동삼겹살 삼부자왕돌판 오랜만이네요~	FALSE
안산 고잔동 맛집 한양대 데이트코스 고기집 '방철쌈' 삼겹살 이상의 돼지고기 영접	FALSE
안산 고잔동 맛집 ♪ 하남돼지집 삼겹살 실패없는 회식장소	FALSE
안산 삼겹살 맛집/고잔동 삼겹살 맛집 안산 회식하기 좋은 고잔일미고깃집~	TRUE
안산 고잔역 맛집 #무한 삼겹 시대 안산점 고잔동 고깃집 1만 원으로 무한 리필 삼겹살을 즐긴다.	FALSE
안산 삼겹살 맛집 고잔동 고기집 제주도깨비 찐이야!	FALSE
[안산 고잔동 맛집] 두툼한 삼겹살이 땡길 땐 '제주삼육돈 고잔점'	FALSE
고잔동 삼겹살 맛집 황제돈 전복은 서비스	FALSE
안산 고잔동 맛집 삼겹살 막창이 맛있는 하남돼지집	FALSE
[배달삼겹살 추천]고잔동 삼겹살 맛집 '미친돼지' 이름처럼 미친 퀄리티와 맛!!	FALSE
"[안산 고잔동] 고잔동 삼겹살 맛집, 안산 회식장소 추천 ,  인생삼겹살 ""고잔일미 고깃집"" 후기"	FALSE
안산 고잔동 삼겹살 맛집 :: 육즙가득한 삼겹살이 맛있는 일미 고깃집 / 안산 회식 / 안산 삼겹살 맛집	TRUE
안산 고잔동 맛집 김치삼겹살은 하남돼지집	FALSE
"고잔동삼겹살맛집! ""고잔일미고깃집"" 두툼하고 육즙 살아있는 꼬기맛집 +ㅁ+"	FALSE
"[ 안산맛집 ] 안산 고잔동 삼겹살 맛집, 고잔일미고깃집"	FALSE
안산 고잔동 고잔일미 고기집에서 삼겹살!	FALSE
안산삼겹살맛집 고잔동 고기집 하남돼지집	FALSE
"안산고잔동맛집 ""장인소곱창"" 곱이 가득해요!"	FALSE
고잔동삼겹살 맛집 왕주먹 추천해용~	TRUE
[안산배달맛집 / 고잔동 삼겹살 배달] '고돼지 안산한양대점' 직화로 구운 삼겹살	FALSE
고잔동삼겹살 삼부자왕돌판 육질은 통이지!	FALSE
고잔동 회식장소 추천 가마솥 삼겹살 맛집 마루야끼	FALSE
황제돈 ː 고잔동삼겹살맛집/삼겹살먹자/안산삼겹살/안산고잔동삼겹살집	FALSE
"[한국방송] 왕 솥뚜껑 복돼지(안산, 단원구, 고잔동, 맛집, 고깃집, 삼겹살, 오겹살)"	TRUE
[안산]고잔동삼겹살맛집 고잔일미고깃집에서 가족외식하고 왔어요~              #고잔동삼겹살맛집 #안산고잔동고기집 #안산회식장소 #안산모임장소 #안산삼겹살맛집	FALSE
"[안산중앙동맛집] 고잔동삼겹살 후기 "" 고기싸롱 """	FALSE
"고잔동 삼겹살 맛집 고잔일미고깃집, 후회없이 배부르게 먹고왔습니다. 강추강추 #소소한추천"	FALSE
<안산 고잔동 맛집> 행복한돼지집 삼겹살 굿굿!	FALSE
"[안산 맛집] 고잔동 삼겹살 유목민들 모두 주목, 김치 쌈(?)겹살 존맛집 “방철쌈”을 소개하지"	FALSE
고잔동 고기집 삼겹살 무한리필을 다양하게!	FALSE
고잔동 맛집 끝내주는 무한장어	FALSE
저렴하고 맛난 안산고잔동맛집<화통삼>삼겹살고기전문점식당	FALSE
"안산 고잔동 맛집 ) 명이나물+삼겹살 맛집 "" 행복한 돼지집 """	FALSE
[안산 고잔동 맛집] 삼겹살 맛집 / 데이트하기 좋은 곳 / 회식장소 - 방철쌈??	FALSE
고잔동 삼겹살 하남돼지집 고잔신도시 맛집으로 임명!!	FALSE
[중앙동맛집 / 고잔동맛집] 안산 삼겹살 맛집하면 여기!! '맛찬들 왕소금구이' 안산중앙점	FALSE
"[안산 고잔동 맛집] 한돈 인증받는 퀄리티 높은 맛있는 삼겹살, 행복한돼지집"	TRUE
안산 고잔동 삼겹살 한참 고기 먹을 나이~	FALSE
안산 고잔동 맛집 핫플 발견!! 데이트코스 고기집 강추 '방철쌈' 숄더렉 영접	TRUE
일짱임! 안산 고잔동 맛집	FALSE
안산 고잔동 냉동삼겹살 맛집 팔공육	FALSE
고잔동삼겹살 삼부자왕돌판 한돈생고기 맛나징~	FALSE
안산 삼겹살 맛집 / 고잔동 삼겹살 맛집 :: 육즙빵빵한 생삼겹살이 생각날 땐 고잔일미고깃집으로~	FALSE
"안산 고잔동 맛집, 삼겹살 끝판왕 하남돼지집 취한다취해!"	FALSE
"안산 고잔동 맛집 ""토종한우"" 맛있는 뼈 삼겹살!! 강추합니다~^^"	FALSE
고잔 일미 고깃집을 가다! #고잔동맛집 #통삼겹 #삼겹살 #회식장소 #고잔동고깃집	FALSE
안산 고잔동 맛집 고퀄리티!	FALSE
"안산 고잔동 맛집!!탄통제주돼지!!!참새방앗간보다 맛집!!고잔동 삼겹살 맛집!!큼지막한 근고기의 매력!안산에서 제일 맛있는 삼겹살,목살 맛집!!"	FALSE
고잔동 맛집::삼겹살에 소주한잔 벽옥생고기식당	FALSE
고잔동 삼겹살 오랜 맛집 삼부자왕돌판!	FALSE
안산 고잔동 고기집 삼겹살 대박집 일미고깃집	FALSE
"안산 고잔동 회식장소로 좋은 삼겹살 맛집, 삼부자왕돌판"	FALSE
안산 고잔동 무한리필 삼겹살과 목살이 맛있는 '국가대표고기집 고잔점'	FALSE
[안산 맛집/고잔동 맛집]짚풀 볏짚삼겹살	FALSE
[안산 고잔동 맛집] 무한장어 / 장어+삼겹살+오리+소고기 무한리필	FALSE
안산삼겹살맛집 「하남돼지집」 안산고잔동 변치 않는 삼겹살 배달 포장 가능 :)	FALSE
안산 고잔동고기집 껍데기맛집 연탄구이 왕주먹	FALSE
고잔동 삼겹살 맛집 :: 고잔일미고깃집 후기!	FALSE
안산 고잔동 맛집 제주도깨비 고잔동 고기 맛집으로 임명합니다.	FALSE
안산 고잔신도시 맛집 고잔동 국민돼지 삼겹살 더덕구이	FALSE
안산 고잔동 냉동삼겹살 맛집 '팔공육'! 냉동삼겹살이 땡길 땐 여기로 가자!!	FALSE
[고잔동 삼겹살 맛집] 저렴한 가격에 만나보는 삼겹살 고잔동 기찬고기	FALSE
"[ 안산 삼겹살 맛집 ] 고잔동 삼겹살 맛집, 두툼한 삼겹살 추천 :: 고잔 일미고깃집"	FALSE
안산 고잔동 맛집 육즙이 끝내주는 곳	FALSE
??<안산 고잔동 고기집>삼겹살이 맛있는 _ 고잔일미 고깃집	FALSE
"고잔동 삼겹살, 제주삼육돈 고잔점 맛이 일품"	TRUE
안산 고잔동ㅣ?안산 고잔신도시 로컬맛집 한돈 삼겹살 찐 맛집 추천 [행복한돼지집]	FALSE
고잔동 맛집 삼겹살이 유명한그집 ☆ 하남돼지집	FALSE
안산삼겹살 안산회식장소 고잔동삼겹살	FALSE
안산 고잔동 맛집! '국민돼지' 냉동삼겹살 먹고왔어요	FALSE
안산 고잔동 맛집 인기있는 핫플레이스 고기집은? 방철쌈!!	TRUE
[고잔동맛집]안산삼겹살맛집 ‘일미고깃집’	FALSE
고잔동 배달 맛집 퀄리티 높은 돈돈한돼지&쭈불쭈불	FALSE
안산고잔동맛집 안산시청앞 다빈 삼겹살 부대찌개 (숨은맛집)	FALSE
"고잔신도시 맛집 ""하남돼지집"" 한돈인증점!! 고잔동 삼겹살 맛있는 꼬기 +ㅁ+"	FALSE
"안산 고잔동맛집 :: 하남돼지집 안산고잔점, 전문가가 직접 구워주니 믿고먹는 안산 삼겹살맛집!"	FALSE
안산 고잔신도시 맛집 : 고잔동 삼겹살 맛집 하남돼지집!!!!	FALSE
안산 고잔동 맛집 데이트코스로 갔다가 찐 삼겹살 고깃집 찾았어요	TRUE
고잔동삼겹살 고기싸롱 고잔점 에서 냠냠	FALSE
안산 삼겹살 맛집 고잔동 고기 구워주는♥ 하남돼지집	FALSE
[안산 고잔동 맛집 : 쭈꾸미도사] 빨간맛의 쭈꾸미삼겹살과 채고조합 치즈폭탄계란찜	FALSE
"[ 안산 고잔동 맛집, 고잔동 삼겹살 ] 믿고 먹는 '하남돼지집' 한돈 전문점!"	FALSE
안산 고잔동 맛집 냉삼과 돈차돌이 유명한 고기집 제주도깨비	TRUE
안산 고잔동 맛집 화로야 삼겹살	FALSE
안산 고잔동 맛집 / 삼겹살데이 회식장소 추천 받고 방철쌈 다녀온 후기♥	FALSE
고잔동 삼겹살 하남돼지집 신메뉴 오겹살 냠냠!	FALSE
고잔동맛집:) 삼겹살은 백팔번집	TRUE
[안산 고잔동 미나리 삼겹살 맛집] 매일고기	FALSE
안산 고잔동 / 안산 삼겹살 맛집 '고잔일미고깃집'	FALSE
"[일상,기록#10]안산고잔신도시/고잔동맛집/전복품은황금돼지/전복삼겹살/대하구이"	FALSE
고잔동맛집 안산조개창고에서 조개부터 고기까지 냠	FALSE
[고잔동 맛집 / 고잔동 배달 맛집] '돈돈한돼지&쭈불쭈불' 삼겹과 쭈꾸미 콜라보	FALSE
안산 고잔동 맛집 고소함의 정석	FALSE
[안산맛집] 고잔일미고깃집 / 안산회식_고잔동 삼겹살 맛집	FALSE
안산 중앙동 삼겹살 맛집 맛찬들에서 동생과 대한민국 1등 삼겹살 먹기	FALSE
[팔공육]안산 고잔동 냉동삼겹살 맛집 이라던데 흠	FALSE
[안산 고잔동 맛집] 고잔역 호수공원 근처 고기집 제주도깨비에서 삼겹살 회식!	FALSE
고잔동 제주 흑돼지 삼겹살 맛집 제주삼육돈	FALSE
안산 고잔동 맛집 고잔동 배달 맛집 '돈돈한돼지&쭈불쭈불	FALSE
안산 고잔동 맛집 제주도깨비 구워주는 곳!! 분위기도 굿!	FALSE
안산 고잔동 맛집 고기원칙 차원이 다른 숙성고기	FALSE
25시광장맛집 '마루야끼' 가마솥 삼겹살 존맛!!!!!!고잔동존맛/고잔동삼겹살맛집/안산존맛	FALSE
안산 고잔동 맛집 하남돼지집 삼겹살 끝내준다	FALSE
안산고잔동맛집 맛있는 삼겹살과 해물냄비를 한꺼번에 즐기자 고잔일미고깃집	FALSE
안산 단원구 고잔동 삼겹살 맛집 추천 고기전문점 이런 맛집이 있었다니! 왕솥뚜껑복돼지	FALSE
안산 고잔동 삼겹살 삼부자왕돌판 :: 안산 회식장소로 추천	FALSE
점심엔 꼬기! 고잔동맛집 206숯불 Meat	FALSE
고잔동 맛집 쭈꾸미와 삼겹살의 찰떡호흡!	FALSE
"안산 고잔동 맛집 하남돼지집, 역시 삼겹살 맛집이야"	FALSE
[안산고잔동맛집] 매일 가고 싶은 돼지 특수모듬구이 맛집 제주도깨비	FALSE
안산 고잔동맛집 팔공육 고기는 냉동삼겹살!	FALSE
[안산 중앙동	FALSE
"고잔신도시, 고잔동 맛집 / 그릴룸, 삼겹살, 목살, 김치말이국수"	FALSE
안산 고잔동 쭈꾸미 이 집 안 가면 후회해요(	FALSE
안산 고잔동 맛집 삼겹살하면 하남돼지집 안산고잔점 !	FALSE
고잔동 배달 맛집 매콤한 쭈꾸미맛집 돈돈한돼지&쭈불쭈불	FALSE
고잔 신도시 맛집 청춘연가 안산고잔점을 가다! #고잔동맛집 #청춘연가 #고잔동삼겹살 #돼지불고기 #부대찌개	FALSE
안산 고잔동 맛집 토종한우 삼겹살 맛집으로 추천 한돈 맛좋아요	FALSE
안산 고잔동 제주도깨비 삼겹살 냠냠!	FALSE
안산 고잔동 맛집 행복한돼지집에서의 주말먹방	FALSE
안산 고잔동 맛집 더덕구이+삼겹살 = 국민돼지	FALSE
고잔동삼겹살배달 맛집 미친돼지 예대점	FALSE
안산 고잔동 맛집 고잔 일미 고깃집 -삼겹살/목살/잔치국수	FALSE
[안산 고잔동 삼겹살 맛집] 하남돼지집 안산 고잔점	FALSE
안산모임장소로 좋은 안산고잔동맛집 영월애곤드레	FALSE
안산 고잔동 고기집 맛집 착한돼지에서 삼겹살뽜뤼~	FALSE
(폐업) [안산 고잔동] 삼겹살 존맛집 '일미' 쫀맛리뷰! ??	TRUE
안산 고잔동 맛집 부드럽소 그냥 살살 녹네	TRUE
RESTAURANT : 안산 삼겹살 맛집 매일고기집 ( 안산 고잔동 )	FALSE
안산무한리필 고기집 고기싸롱 고잔동삼겹살 맛있어요	FALSE
안산 중앙동 삼겹살 맛집 맛찬들 강력추천	FALSE
안산고잔동맛집 안산한정식 영월애곤드레 안산점	FALSE
"안산고잔동맛집, 안산양꼬치 # 친우양꼬치 :)"	FALSE
안산 고잔동 고기집 '하남돼지집' 안산 회식장소 고기 맛집으로 추천 :)	FALSE
[제주 삼육돈 고잔점] 안산 고잔동 맛집 추천?_ 안산 삼겹살은 여기로~??	TRUE
먹부림) 안산 고잔동 제주삼육돈 / 안산맛집 / 안산고기집 / 고잔동맛집 / 고잔동삼겹살 / 고잔동맛집추천 / 제주삼육돈메뉴판	FALSE
[안산 고잔동 맛집] 훈이네 꿀돼지갈비 숯불꼼장어 콩나물삼겹살	FALSE
안산 고잔동 삼겹살맛집 소문난생삼겹살 솔직후기 (안산맛집/안산와동맛집)	FALSE
안산 고잔동 삼겹살 참숯직화로 더 맛있는 정직한생고기	FALSE
안산 고잔동 고기맛집 제주도깨비 서울에서 안산까지 갈 정도로	TRUE
"[안산고잔동족발/안산보쌈] 족발과 보쌈을 함께 즐길 수 있는 고잔동 맛집 ""대가보쌈과 냉채족발"""	FALSE
안산 고잔동 맛집 오길 잘했어!	FALSE
안산 고잔동맛집 206 숯불 미트에서 점심 먹은 후기	FALSE
[안산맛집] 고잔동 행복한돼지집 삼겹살맛집	FALSE
[안산 고잔동 맛집] [석쇠로 770] 연탄불로 초벌구이하는 고추장삼겹살	FALSE
안산 고잔동 맛집 가족 외식하기 좋은 황제 해물 보쌈	FALSE
"안산 고잔 맛집 제주산 돼지고기만 취급하는 고잔동 고깃집 제주도깨비, 데이트 장소로 찰떡"	FALSE
안산 고잔동 맛집 4가지 부위를 한번에 즐길 수 있는 고기집 '방철쌈'	FALSE
"[안산고잔동맛집]안산 삼겹살맛집_""제주삼육돈 고잔점"""	FALSE
안산회식장소 고잔동 하남돼지집 오겹살에 삼겹살 뿌셨지	FALSE
안산 삼겹살 맛집 고잔동 일미	FALSE
고잔동	FALSE
[안산] 고잔동 철판 김치 삼겹 찐맛집 고깃집 추천 : 방철쌈	FALSE
안산 회식 - 고잔동에서 삼겹살이 맛있는 일미고깃집	FALSE
안산맛집/고잔동맛집-훈이네 꿀돼지갈비 콩나물삼겹살	FALSE
안산 고잔동 배달 맛집 - 돈돈한돼지&쭈불쭈불	FALSE
"안산 고잔동 맛집 ,명품장어 에서 신랑이랑 장어구이로 몸보신하다"	FALSE
"고잔동 삼겹살, 고잔신도시 맛집 하남돼지집 완전 강츄.."	FALSE
[안산 맛집] 야장에서 즐기는 삼겹살 고잔동 본심	FALSE
안산 고잔동 맛집 고잔일미고깃집에서 삼겹살홀릭	FALSE
"안산 고잔동, 삼겹살+소주 무한리필 서울회관"	FALSE
안산 고잔동 맛집 서울회관 무한리필 대패삼겹살+소주 무한리필	FALSE
고잔동 맛집 가성비 최강 소불고기 신라불고기	FALSE
"고잔동 삼겹살 하남돼지집 안산 회식장소, 가족외식으로 좋아요"	FALSE
고기원칙에서 다온카드 사용하여 외식을 해봄. [안산 고잔동]	FALSE
"안산 고잔동 고기집, 삼겹살맛집! 안산 회식 모임 장소 추천 고잔일미 고깃집"	FALSE
안산 중앙동 고잔동 삼겹살 맛집 - 맛찬들 왕소금구이	FALSE
안산 삼겹살 맛집 토종한우 / 고기는 물론 식사메뉴도 다 맛있는 고잔동 맛집	FALSE
안산 고잔동 맛집 진짜루맛남! ?????	FALSE
안산회식장소추천!! 고잔동삼겹살집은 삼부자왕돌판에서 한돈으로 먹어요!!!	FALSE
고잔동삼겹살맛집 추천! 안산 황제돈!	FALSE
안산 삼겹살 맛집 참숯초벌구이 전문 고잔동 삼겹살 매일고기	FALSE
안산 고잔동 맛집 행복한돼지집! 삼겹살이 맛있는 곳이에요.	FALSE
[안산 고잔동 맛집] 육장장이/ 양념 갈비가 맛있는 무한리필 고기집	FALSE
[고잔신도시맛집] 안산 고잔동 고깃집 추천 고잔일미 : ) 고잔신도시 삼겹살맛집 회식장소추천	TRUE
[안산맛집/고잔동맛집] 삼겹살이 맛있는 매일 고기집	FALSE
안산 고잔동맛집 영월애곤드레 에서 가족모임	FALSE
안산고잔동 신나라돼지나라  솥뚜껑삼겹살 항정살 생고기 맛있는 고깃집명당	FALSE
안산 고잔동 맛집 [제주도깨비] 서비스 좋은 회식장소 추천	FALSE
안산 고잔동 맛집 - 삼겹살은 뭐니뭐니해도 하남돼지집	FALSE
고잔동맛집 안산 김치 삼겹 제대로 먹을 수 있는 고기집 방철쌈	FALSE
[안산 고잔동맛집] 어버이날 맛집은 역시 영월애곤드레!	FALSE
<안산 고잔동 맛집> 행복한돼지집에 재방문해서 삼겹살 먹었어요♪	FALSE
안산 고잔동 삼겹살 고잔신도시 삼부자왕돌판 본점	FALSE
[안산맛집/고잔동맛집]화로야 양념돼지갈비&삼겹살	FALSE
[안산]하남돼지집 고잔동 고기 구워주는 안산삼겹살맛집	FALSE
고잔동맛집)안산 한정식으로 유명한 '영월애곤드레' 얌얌!	FALSE
고잔동에 위치한 삼겹살 맛집_ 행복한돼지집	FALSE
삼겹살 먹고플땐 고잔동맛집 행복한돼지집~	FALSE
[안산] 고잔동 맛집!! 솥뚜껑 삼겹살집!! 볶음밥도 별미!!! '마루야끼'	FALSE
안산 고잔동맛집 (안산 한정식) 영월애곤드레 최고였당	FALSE
[경기도/안산]	FALSE
"안산 고잔동 맛집, 하남돼지집 고잔점 - 안산에서 제일 맛있는 고깃집 전문적으로 삼겹살 구워주는 인생찐맛집 하남돼지집 고잔점 ??"	FALSE
[안산맛집] 안산 고잔동 맛집/안산 고잔신도시 맛집/안산 삼겹살 맛집 고잔일미고깃집	TRUE
고잔동맛집 삼겹살에 쌈싸먹기~!!	FALSE
안산고잔동맛집 존맛인 고기집일쎄	FALSE
안산 투파인드피터 연말에 가면 좋을 고잔동 레스토랑 맛집!	FALSE
"고잔동 맛집 초지참숯불갈비, 껍데기가 무한리필!! 고기질도 너무 좋은곳!!"	FALSE
안산 삼겹살 맛집 :: 토종한우정육	FALSE
안산 고잔동 맛집:: 고잔동 하남 돼지집에서 맛저녁 먹었어요 :)	FALSE
안산 고잔동 맛집 고기맛이 좋은 안산 한우 맛집  '토종한우'	FALSE
"안산 고잔동 맛집, 고잔신도시 하남돼지집!"	FALSE
안산삼겹살 고잔동 삼부자왕돌판 매장 리뉴얼했네요	FALSE
안산 고잔동 맛집 하남돼지집 삽겹살 파티♪	FALSE
[안산고잔동맛집] 마루야끼 / 안산고잔동삼겹살 / 솥뚜껑삼겹살	FALSE
고잔동삼겹살 -마루야끼- 진짜맛있어	FALSE
안산 고잔동 맛집 화로야	FALSE
안산 오겹살이 맛있는 토종한우 고잔동고기집 추천	TRUE
고잔신도시 맛집 삼겹살은 고잔동 하남돼지집이 JMT	FALSE
안산삼겹살 고잔동맛집 백팔번집 !!!	FALSE
안산 고잔동 '하남돼지' 삼겹살 맛집이에요~!	FALSE
안산고잔동맛집 여기야생고기 삼겹살/목살/떡갈비가 9900원의 무한리필	FALSE
안산 고잔동 맛집 고구려 한식 삼겹살	FALSE
"고잔동 고기집 명가금돼지, 소갈비살이 맛있는 리얼 고잔동 갈비 맛집"	FALSE
[안산 고잔동 맛집] :: 훈이네 - 맛있는 삼겹살 서울예대 앞에서 즐기세요!!	FALSE
안산 고잔동 맛집 추천 :: 상황돈	FALSE
"[안산맛집] 안산 고잔동 냉동삼겹살맛집 감성자극 ""총각수퍼"" 적극추천"	FALSE
[안산 고잔동 맛집/안산 고기집 맛집]하남돼지집♥ 삼겹살 짱 마싯오	FALSE
안산 고잔동 삼겹살엔 하남돼지집이 최고지	TRUE
안산고잔동맛집 마루샤브	FALSE
안산고잔동삼겹살 맛있는곳	FALSE
안산 고잔동 맛집 - 고기파이터에서 삼겹살 먹었더니 전복이! 소주는 천원?!!	FALSE
[안산고기뷔페/고잔동맛집] 공룡고기 무한리필~꼬기~꼬기~♥	FALSE
고잔동맛집 황제돈 전복삼합의 꿀조합~	FALSE
[안산맛집/고잔동맛집 마루야끼 솥뚜껑 삼겹살]	FALSE
안산 고잔동 맛집 중앙역 구미가	FALSE
"안산 고잔동 맛집, 삼겹살집 추천, 하남돼지집 - 완전 친절하고 맛있는 고기집!"	FALSE
안산 고잔동 일미고깃집 통삼겹살 맛집!!	FALSE
[고잔동 맛집] 안산 삼겹살 찐맛집 '하남돼지집' 안산고잔점	FALSE
고잔동맛집 소고기가 살살녹는 둥이상회	FALSE
<안산/고잔동> 고잔신도시 삼겹살맛집 고잔일미고깃집	TRUE
"안산회식장소 / 안산삼겹살맛집 ""하남돼지집 안산고잔점 후기 !"	FALSE
안산맛집 고잔동 먹물오징어	FALSE
"안산 고잔동 맛집,안산맛집,맛집추천,(구 하남돼지집),행복한 돈,안산고기맛집,삼겹살맛집"	FALSE
고잔동 맛집 둥이상회에서 맛있게 저녁식사했어요	FALSE
안산고잔동맛집 : 삼겹살 돼지고기 맛있는곳 카우앤피그 : 가성비갑 : 회식장소추천	FALSE
"안산 고잔동 맛집 '국가대표 고잔점' 12,900원 8가지 고기 무한리필"	FALSE
안산 고잔동 맛집 토종한우 안산 삼겹살 맛집 인정!!	FALSE
안산 고잔동 맛집 :: 고기맛집 회식장소로 유명한 화로야에서 가족외식하고 왔어요.(feat.삼겹살추천)	FALSE
안산고잔동맛집 영월애곤드레 안산점	FALSE
안산 고잔동 맛집 :: 화통삼 - 화덕구이 통 삼겹살	FALSE
(안산 고잔동)무한리필맛집 여기야생고기	FALSE
안산 고잔동맛집 맛찬들 왕소금구이 맛있다!	FALSE
안산회식장소 삼부자왕돌판 한돈 생고기 고잔동삼겹살 존맛보스~!	FALSE
안산고잔동 맛집 황제돈 안산 회식장소추천해요 ~	FALSE
"안산 고잔동 맛집 영월애곤드레, 시어머님 맛있는 한정식 대접하기 ♪"	FALSE
안산 맛집 찐맛있었던 고잔동 고기집 제주도깨비	TRUE
안산 삼겹살 고잔동고기집 삼겹살 소고기 두가지고기를 한번에 즐길수있는 토종한우	TRUE
"고잔동 맛집, 회식장소로 딱 좋은 구워주는 고기 하남돼지집!"	FALSE
안산 고잔동 맛집 <조개창고> 시간제한 없이 무제한 이용 가능!	FALSE
안산 고잔동고기집 웨촬전 마지막 폭주 데이트 방철쌈	FALSE
안산 고잔동 맛집 제주도깨비 고잔 신도시 고기집 추천	TRUE
안산 고잔동 곱창 대창 막창 삼겹살 맛집 중앙황소곱창	FALSE
내입에 딱인 안산 고잔동 맛집	FALSE
먹부림) 안산 고잔동 국민돼지 / 고잔동삼겹살 / 고잔동고깃집/ 고잔동맛집 / 안산홈플러스맛집 / 국민돼지 메뉴판	FALSE
안산 미나리 삼겹살 있었다!!! 고잔동 매일고기	FALSE
안산술집/안산분위좋은/안산이자카야/안산고잔동맛집/안산고잔동술집/안산고잔동아오모리 : 고잔동술집 분위기깡패	FALSE
"안산 고잔동 맛집, 안산 삼겹살 맛집 / 토종한우"	FALSE
안산 배달 도시락 : 고잔동 맛집 '본도시락 안산고잔점'에서 든든한 한끼	FALSE
"[안산/고잔동/와동 맛집] 오랜만에 재방문한, 내모메좋은쌈밥 (생생정보통 쌈밥집)"	FALSE
[안산 고잔동 맛집] 제주도깨비 (본삼겹살)	FALSE
안산 고잔동 맛집 무한장어에서 가족외식했어요 ~	FALSE
안산삼겹살맛집 워터맨추천맛집 고잔동삼겹살맛집 고잔신도시삼겹살집추천 고잔신도시통삼겹살 고잔신도시뼈삼겹살 고잔신도시정육식당 고잔신도시회식하기좋은곳 고잔신도시맛집 고잔동우리동네맛집	FALSE
얼큰한 김치찌개가 먹고 싶을때는 고잔동 김치찌개 / 고잔동 삼겹살 이 맛있는 안산시청 맛집 으로...	FALSE
고잔동 맛집 - 고기고기 먹으러 화통삼!!!	FALSE
안산 고잔동 맛집 오리집 구미가 가성비와 맛 둘 다 엄지척	FALSE
[안산 고잔동] 마루야끼 삼겹살 맛집 ( 안산맛집 )	FALSE
안산고잔동맛집 하남돼지집	FALSE
안산고잔동 맛집 황제돈 안산회식장소추천해요~!	FALSE
고잔동삼겹살무한리필 여기야생고기 안산문화광장맛집인정!	FALSE
안산 고잔동 맛집 오어키친 OAR Kitchen (까르보나라 맛집 )	FALSE
<안산맛집/고잔동> 저렴하고 맛있는 삼겹살 '도네누'	FALSE
고잔동맛집// 삼겹살이 맛있었던 고잔동맛집 동양육대감!!	FALSE
"숙성 한우가 입에서 살살 녹았던 부드럽소 안산점, 고잔동 소고기 맛집"	FALSE
[안산 고잔동 맛집] 고잔일미 (삼겹살맛집/안산회식장소/안산모임장소/안산삼겹살맛집/고잔동고기맛집)	FALSE
"안산 고잔동 맛집/ 방철쌈, 네가지 부위의 다양한 맛을 즐기는 가성비  고기집"	TRUE
"안산고잔동맛집 :: 고기나라, 오랜만에 온가족이 다함께 돌판에 삼겹살파티!!"	FALSE
"안산 고잔동 숨어있는 삼겹살 맛집, 행복한 돼지집 (feat. JMT)"	TRUE
안산 고잔동삼겹살 삼부자왕돌판 한돈 돼지고기!	FALSE
"안산 고잔동 삼겹살, 역시 하남돼지집이지."	FALSE
[안산무한리필맛집] 고잔동 돼지고기맛집 청정한돈	FALSE
고잔동 맛집 - 고잔동에 상륙!! 육즙 풍부한 '하남 돼지집'	FALSE
고잔동맛집) 안산고기뷔페 공룡고기	FALSE
안산맛집 고잔동 제주삼육돈 생고기 찐맛집?? 재방문의사 200%	FALSE
안산삼겹살맛집 :: 하남돼지집 고잔점 안산회식장소로도 추천	FALSE
안산 삼겹살 맛집 제주삼육돈에서 배부르게 먹고 왔어요!	TRUE
안산고잔동맛집 영월애곤드레 안산 가족모임으로 강추	FALSE
안산 고잔동 맛집 / 안산 장어맛집 무한장어 오리고기 소고기 삼겹살 술 까지 무한리필!!	FALSE
안산삼겹살맛집 설명이 필요없는 하남돼지집 안산고잔점	TRUE
[안산 고잔동 맛집]내모메좋은쌈밥	FALSE
고잔동맛집 가을신메뉴 '갈릭홀릭' 즐길 ☆ 애슐리 고잔NC점	FALSE
"고잔동 맛집, 내모메좋은쌈밥 후기"	FALSE
"안산 고잔동 레이크푸르지오 앞 삼겹살 맛집 ""고잔일미고깃집"""	FALSE
안산맛집 ) 삼겹살 맛집 & 회식 장소 추천 _ 고잔동 하남돼지	TRUE
"[안산/고잔동맛집] 푸짐한 인심이 돋보이는 안산쌈밥, '쌈천하' (야채, 강된장 무한리필 굿!!)"	FALSE
[안산 고잔동맛집] 안산한정식 영월애곤드레에서 맛있는 한끼	FALSE
"고잔동 맛집, 호수동 맛집 ""맛찬들 왕소금구이""에서 삼겹살 냠냠"	FALSE
고잔동 맛집 전복삼합구이를 맛있게 즐길 수 있는 곳	FALSE
고잔동 맛집/안산 고기집 맛집 하남돼지집	FALSE
안산 중앙동 맛집 / 고잔동 맛집 - 월남쌈과 삼겹살의 케미 ♡	FALSE
맛은 기본! 기본반찬 대박! 가성비 돼지갈비 최고! - 안산 고잔동맛집 명가금돼지 강추합니다!	FALSE
"안산한정식 영월애곤드레, 안산 고잔동맛집으로 인정"	FALSE
"안산 고잔동 맛집 김제한우 먹방,안산맛집추천"	FALSE
안산 평범하지만 특별했던 고잔동데이트 (f.숙성삼겹살 먹태구이)	FALSE
고잔동맛집 - 안산 갈비의 참맛 마포생갈비	FALSE
<안산 고잔동 맛집><안산 회식장소 추천> 암퇘지생삼겹살이 맛있는 고기파이터에 다녀왔어요	FALSE
안산 고잔동 맛집 하남돼지집 육즙터지는 맛있는 한돈전문점!	FALSE
기운없을땐 안산고잔동맛집 꼬기 먹으로 가요~	FALSE
"안산 고잔동 맛집, 하남돼지집"	FALSE
안산 고잔동 고기집 삼겹살 맛이 기가막혀요 행복한돼지집 내 돈 후기	FALSE
"[안산 고잔동 생고기 맛집 ""왕주먹] 안산 고잔동 목살 맛집/안산고잔동 껍데기맛집/ 안산고기맛집 /안산신도시맛집"	FALSE
안산 고잔동 맛집:: 무한장어 꼬리는 누구꺼?ㅋㅋ	FALSE
안산 고잔동 고기맛집 리가든	FALSE
[고잔동 숙성 삼겹살 맛집] 고잔동 세상에 이런 삼겹살 집이!! 다 퍼주는 '고기원칙'	FALSE
안산 고잔동 맛집 생선먹으러가유	FALSE
안산 고잔동 맛집 일등한우 일등할만 하네요.	FALSE
(고잔동) 고기싸롱	FALSE
안산 고잔동 맛집 그릴룸 목살이 짱맛이다 진짜	FALSE
안산 고잔동 고기맛집 방철쌈	FALSE
"안산 고잔동 혼밥 덮밥 맛집, 핵밥 안산고잔점 고기듬뿍덮밥 ??"	FALSE
"안산 고기집 맛집,하남돼지집 고잔동 맛집으로 인정!!!!!!"	FALSE
[About time] 퇴근 후 걷기좋은 배곧한울공원과 그녀가 사준 안산 고잔동 방철삼삼겹살 ;)	FALSE
안산 고잔동 맛집 안산 고잔동 고기집 [무한삼겹시대 안산점] 삼겹살+된장찌개 무한리필	FALSE
♡안산 고잔동 횟집 : 육해공 포차포차_고잔동 맛집 / 회식장소 / 모임장소	FALSE
"안산 고잔동 맛집 ""황제돈' 차돌박이+전복+키조개의  차돌전복삼합구이"	FALSE
[안산고잔동맛집] 가족외식하기 좋은  안산한정식집 영월애곤드레 안산점	FALSE
[안산]고잔동 맛집 - 하남돼지집 삼겹살 꿀맛 ♥? 고기맛집	FALSE
"[안산고잔동맛집] 다양하게 싸먹으니 더 맛있는 김치구이 삼겹한판, 방철쌈"	FALSE
안산 고잔동 감자탕 맛집 신도시에 새로 생긴 주곰감자탕	FALSE
안산 고잔동 맛집 어서와 일식 라멘은 처음이야 휘니치로 데이트	FALSE
[맛집] 고잔동 골목돼지	TRUE
[안산 고잔동 맛집] 명품삼겹살을 직접 구워주니 더 맛있는 하남돼지집	FALSE
[안산맛집]고잔동 삼겹살도먹고 축구도 볼수있는 화로야 추천해요	FALSE
"내돈내산 후기 :: 안산 고잔동 고급지고 깔끔한 삼겹살맛집 , 그릴룸"	FALSE
고잔동 예대앞 맛집 훈이네 꿀돼지갈비?콩나물삼겹살/ 점심특선 백반집 가성비 짱!	FALSE
입소문난 고잔동 삼겹살 :: 제주도깨비	FALSE
"안산맛집 고잔동맛집 ""진성관"""	FALSE
[안산 쌈밥] 고잔동 맛집::내모메좋은쌈밥 먹방	FALSE
안산 고잔동 맛집 삼겹 배달포장전문점 돈돈한돼지&쭈불쭈불	TRUE
[안산고잔동맛집] 명품쭈꾸미&부대찌개 진짜 맛있다-!!	FALSE
[안산맛집/고기집추천] 안산 고잔동 맛집 행복한돼지집	FALSE
[안산맛집] 안산 고잔신도시 맛집/안산 고잔동 맛집/안산삼겹살맛집 하남돼지집 안산고잔점	FALSE
안산 고잔동 맛집 자연별곡 안산점에서 육해진미를 즐겨요!!	FALSE
<안산 고잔동 맛집/안산 고잔동 삼겹살> 삼겹살에 갈비는덤으로! 반반한덤구이	FALSE
안산 고잔동 배달 맛집 혼밥대왕 삼겹살비빔밥&제주흑돼지김치찌개	FALSE
안산고잔동맛집 애슐리 치즈시즌 치즈축제 제대로! 배터질뻔	FALSE
"안산 고잔동 맛집, 화끈하게 먹고왔다 고기파이터!"	FALSE
[안산고잔동맛집:영월애곤드레] 한정식으로 잘나오는! 안산가족외식하기 좋은 영월애곤드레go!	FALSE
?[안산 고잔동 맛집]황제돈의 삼겹살루 몸보신든든!!	FALSE
"선와고(선부동, 와동, 고잔동) 맛집, 모란삼겹살"	FALSE
고잔동 이자카야 춘2호점 / 구월동 냉동삼겹살 맛집 철뚝집	FALSE
"(안산 고잔동시 삼겹살맛집 일미고깃집) 통삼겹1, 통목살1, 공기밥2, 김치찌개1, 사이다1"	FALSE
"휘니치로 :: 안산 중앙동 고잔동 맛집 , 일본식 라멘"	FALSE
안산고잔동맛집 스미스미트앤샐러드에서 맛있는 숙성고기 먹었어요~	FALSE
안산 고잔동 맛집! 고잔동 고기 맛집은 원조 마포생갈비	FALSE
고잔동 맛집 '고잔일미고깃집'	FALSE
[안산고잔동맛집/안산양꼬치] 친우양꼬치	FALSE
안산 고잔동 맛집 하남돼지집 역시 삼겹살은 여기가 최고봉	FALSE
[안산/중앙역맛집] 안산고잔동 애슐리w	FALSE
고잔동 맛집 ) 행복한돼지집  명이나물과 삼겹살의 조화	FALSE
안산 고잔동 시청 앞 삼겹살 맛집 - 김제삼	FALSE
"[안산 고잔동 맛집/와동 맛집] ""내모메좋은쌈밥""에서 삼겹살쌈밥을 먹었어요!"	FALSE
"안산 중앙역 맛집 본삼겹살 맛있는 제주도깨비에서 저녁, 데이트코스 추천해요 ㅎㅎ"	TRUE
[안산고잔동맛집] 명이나물과 함께먹는 고기! 행복한 돼지집	TRUE
[고잔동맛집/뒷고기맛있는집]고잔신도시 마장동뒷고기 정말 고소하고 맛있어요~	FALSE
안산맛집 고잔동 고기집 실속있는 반반한덤구이	FALSE
[차파는청년] 안산 고잔동맛집 제주도깨비 ! 고잔동 데이트코스 맛집 제주도깨비!	FALSE
[안산 고잔동 맛집] -  꺼멍연탄구이에서 제주 근고기 먹기 ♥	FALSE
[안산 고잔동 맛집 / 한방감자탕삼겹살] 안산맛집 고잔동 검찰사거리 한방감자탕 생삼겹살추천	FALSE
애슐리 가을신메뉴 고잔동 맛집 애슐리 고잔점다녀왔어요	FALSE
[고잔동 맛집] 찐으로 맛있는 고기집 식껍 안산고잔점	FALSE
안산고잔동맛집 한마음고기&샐러드바 다른고기부페와 다른점!	FALSE
안산 고잔동 두툼한 오겹살이 있는 뜯어뜯어 쪽갈비랑 생삼겹살	FALSE
[안산/고잔동] 파스타 맛집 “포크너”	FALSE
안산 고잔동 맛집 # 황제돈	FALSE
안산 고잔동 맛집  짚풀볏짚삼겹살	FALSE
"[안산중앙역맛집, 고잔동맛집, 안산 쭈꾸미] 쭈꾸미브라더스 안산점"	FALSE
안산 화통삼 삼겹살집. 안산 맛있는 삼겹살집.[안산 고잔동 맛집]	FALSE
안산 고잔동 맛집 안산 고잔동 고기집 무한삼겹시대에서 위대한가족이 삼겹살 무한 흡입하고 왔어요~ㅋ	FALSE
안산 고기집 제주숙성고기 파는 삼겹살 맛집(ft.데이트코스)	TRUE
고잔동 맛집 :: 고잔일미고깃집	FALSE
안산/고잔동 고기집 맛집 제주도깨비	FALSE
안산 고잔동 맛집.상황돈	FALSE
안산 회식장소는 고잔동 삼겹살 하남돼지집 에서	FALSE
고잔동 삼겹살 제주도깨비	FALSE
"[고잔동맛집] 넌 먹기만 해 굽는건 내가 할게 ""하남돼지집 안산고잔점"" 안산회식장소로 딱이야!"	FALSE
안산 고잔동 배달 맛집 돈돈한돼지&쭈불쭈불 추천!!	FALSE
"제주돈고집 :) 안산 고잔동 오겹살, 삼겹살 맛집 솔직후기"	FALSE
김치찌개가 맛있는 고잔동 김치찌개 / 고잔동 삼겹살 / 안산시청 맛집 / 안산 호수공원 맛집 추천합니다.	FALSE
[안산호수동맛집] 안산 중앙동 삼겹살 맛있는 집 '맛찬들' 다녀왔어요~ (안산고잔동맛집 고깃집추천)	FALSE
"18.09.30 안산 고잔동 유황돼지 - 안산고잔동맛집, 안산중앙동맛집, 안산삼겹살맛집"	FALSE
고잔동맛집 :: 박가네한우곰탕 차돌박이 & 한우곰탕 맛있는 안산밥집	FALSE
고잔신도시방철쌈 고잔신도시삼겹살 중앙동삼겹살 안산삼겹살맛집	FALSE
[공룡고기]안산고기뷔페-안산무한리필-고잔동맛집-안산고기집 - 고기부페추천	FALSE
고잔동 맛집 : 무한리필 장어랑 삼겹살이랑 같이 먹을 수 있는 @ 무한장어	FALSE
<안산> 중앙역 고잔동 고기맛집 “고기나라”에서 삼겹살이랑 볶음밥!	FALSE
"안산 고잔동 맛집, 일미고깃집"	FALSE
9월2일 안산 고잔동 맛집- 무궁화생고기 왕숯불소금구이	FALSE
안산 고잔동 고기집 하남돼지집 다녀왔습니다! [고잔동 삼겹살]	FALSE
[ 안산 고잔동 맛집 / 안산 갈비 / 안산 수제갈비 / 안산 맛집 추천  ] 새로생긴 수제갈비 고잔점에서 맛있게 식사하고 왔습니다~	FALSE
안산 고잔동 맛집 : 매일고기	FALSE
[안산 고잔동 맛집 : 토리아에즈] 즉석에서 구워주는 꼬치전문점	FALSE
[안산고잔동맛집] 본심	FALSE
고잔동 삼겹살 맛집 화통삼 맛있네요~♡	FALSE
안산냉동삼겹살맛집 냉삼한상 고잔점 삼겹포차 냉삼맛집으로 추천	FALSE
안산 고잔동 맛집 고기파이터	FALSE
[안산맛집/고잔동맛집] 화로야	FALSE
[고잔동 삼겹살] 삼부자 왕돌판 삼겹살 또 먹을래요ㅎㅎ	FALSE
안산고잔동맛집 소고기 참 부드럽소	FALSE
"[안산 맛집]안산고잔동고기맛집, 직접먹어본 맛집 추천 ‘고잔일미’"	FALSE
안산 고잔동 맛집 황소 소개합니다.	FALSE
안산 고잔동 맛집 : 깔끔한 한식요리 반궁 명이나물건강보쌈한상 후기	TRUE
"삼부자왕돌판 안산삼겹살,"	FALSE
안산 중앙동 맛집 : 직접 구워주는 육즙가득 삼겹살 맛집 하남돼지집 중앙역점	FALSE
안산 고잔동 삼겹살 정직한생고기 맛있어요!	FALSE
안산 고잔동 보쌈 맛집 돈돈보쌈에서 보쌈 먹기!	FALSE
안산 맛집!!고잔동 하남돼지집 삼겹살!!	FALSE
[안산 고잔동 맛집] 본심	FALSE
[안산맛집]고잔신도시맛집/하남돼지집/고잔동맛집/고잔동삼겹살	FALSE
안산 고잔동 고기맛집 “야끼화로”	FALSE
"(고잔동 맛집) 안산 하남돼지집, 삼겹살 맛집"	FALSE
안산 고잔동 맛집 <왕주먹>::목살고기와 갈치속젓의 환상 궁합	FALSE
안산 삼겹살 맛집 하남돼지집 고잔점 _ 전문가가 구워주는 고기	FALSE
"안산 고기 맛집, 삼겹살은 역시 ‘맛찬들’"	FALSE
안산 고잔동 이자카야 맛집_이자카야 춘	FALSE
"""우리한돈 연구소"""	FALSE
내돈내산 안산 고잔동 가성비 고기 맛집이었던 고기싸롱	FALSE
(안산 단원구) 고잔동 먹자골목 하남돼지집 삼겹살 맛집 ??	FALSE
고잔동 맛집 _ 맛있는 고기를 무한으로 푸짐하게 즐길 수 있는 여기야 생고기 안산 고잔점!!	FALSE
안산 고잔동맛집_그릴룸 삼겹살 :-P	FALSE
안산 고잔동 삼겹살 : 고잔일미고깃집	FALSE
[고잔동맛집/애슐리갈릭축제]애슐리 가을신메뉴 갈릭축제 후기	FALSE
안산 고잔동맛집 먹자골목 볏짚삼겹살 '짚풀' 3인분 주문시 1인분 공짜!	FALSE
안산 고잔동 고기집 아리화 살살녹는 고기 강추♥	FALSE
고잔동 맛집/김제한우 안산/안산에서 진짜 맛있는 한우고깃집을 찾으신다면 바로 요기!!	FALSE
안산 고잔동 맛집 행복한돼지집에서 맛있는 우리돼지 한돈 먹고 왔어요!!	FALSE
푸짐했던 안산 고잔동 맛집 탑2	FALSE
고잔신도시 맛집_탄통제주돼지 삼겹살맛집!!	FALSE
안산 고잔동 맛집 고기싸롱 무한리필고기집 맘에 들어	FALSE
[안산맛집] 고잔동 고깃집 “고기싸롱” ??	FALSE
[안산 고잔동 맛집] 고잔동 무한리필 '여기야 생고기'	FALSE
"18.01.15 안산 고잔동 하남 돼지집 - 안산고잔신도시맛집, 안산삼겹살맛집, 안산하남돼지집"	FALSE
고잔신도시삼겹살식껍 고잔신도시특수부위 고잔신도시삼겹살맛집	FALSE
"안산 고잔동 맛집, 일미고깃집"	FALSE
안산 고잔동 고기 맛집 <제주삼육돈> 무한리필 흑돼지전문점	FALSE
"하남돼지집 - 고잔동 삼겹살, 고잔동 고기집"	TRUE
중앙역맛집 고잔동맛집 김치찌개 전문점 '돈가' 단골할래요	FALSE
안산 고잔동 맛집 경복돼지생고기에서 삼겹살야장	FALSE
안산 ㅡ 분위기 좋은 파스타 맛집  고잔동 <쉐프스 라운지>	FALSE
[안산무한리필/고잔동맛집] 스미스미트&샐러드	FALSE
"안산 고잔동 고깃집 삼겹포차 냉삼한상, 콩불한상 고잔점"	FALSE
고잔 신도시 삼겹살 맛집 제주도깨비>.<	FALSE
할로윈데이/안산맛집/고잔동맛집/마포생갈비	FALSE
안산 냉동삼겹살 맛집 '서울식당' 중앙동 모임장소 인싸들 모여(ft.아날로그감성술집)!	FALSE
"[안산/고잔동맛집] 그릴룸 (목살, 치즈주먹밥구이 맛집)"	FALSE
"안산 중앙동 맛집, 삼겹살은 '맛찬들 왕소금구이'"	FALSE
안산 고잔동 생고기전문점 고기맛집 (왕주먹)	FALSE
"[안산고잔동맛집]""꼴통삼겹"" / 25시먹자골목쪽/삼겹살"	FALSE
안산  중앙동(고잔동)냉동 삼겹살 맛집~♥	FALSE
"안산 고잔동 배달 맛집 삼겹,배달쭈구미 추천 - 돈돈한돼지&쭈불쭈불"	FALSE
고잔신도시 맛집 삼겹살은 역시 하남돼지집	FALSE
[안산] 고잔동 맛집! 안산에서 느끼는 흑돼지의 맛! '꺼멍연탄구이'	FALSE
이승환참치 안산 고잔동 참치맛집 걍대박!!!	FALSE
안산고잔동맛집 : 인생 양꼬치 별빛양꼬치	FALSE
"안산 고잔동 맛집, 제주도깨비 (고잔동 고기맛집)"	FALSE
안산 고잔동 삼겹살 하남돼지집 구워주는 고기집이여서 좋다.	FALSE
[안산고잔동맛집] 고잔일미 고깃집	FALSE
[안산 중앙역 맛집 착하다삼겹!!]-고잔동 맛집/ 안산 무한리필/ 안산 고기뷔페/ 삼겹살 존맛집	FALSE
안산 고기집 삼겹살은 고잔동 토종한우	FALSE
안산 중앙역 맛집 삼겹살 맛있는 제주도깨비에서 데이트 다온 가맹점이에요	FALSE
[안산 제주도깨비] 고잔동 존맛탱삼겹살을 찾으시나요? 돼지고기맛집??	FALSE
"안산 중앙동 삼겹살, 이베리코 플루마 맛집 '맛찬들'"	FALSE
"안산 고잔동 삼겹살,솥뚜껑 마루야끼 맛 공개!"	FALSE
"(군침주의) 돼지고기 먹고 싶을 땐, 고잔동 206숯불미트! [안산 맛집, 고잔동 맛집, 안산 삼겹살, 핫이슈 그집, 안산 회식, 안산 가족외식]"	FALSE
안산 고잔동 솥뚜껑 삼겸살 맛집 / 마루야끼	FALSE
"안산 고잔동 무한리필 '고기싸롱 고잔점' 13,500원 가성비 최고 맛집"	FALSE
[안산 고잔동 맛집 ] 고기쌀롱 안산 무한리필 맘껏먹었쥬????	FALSE
안산삼겹살맛집_두말하면 잔소리	FALSE
안산회식장소 고잔동삼겹살 삼부자왕돌판	FALSE
안산 고잔동 맛집 / 마루야끼 삼겹살 / 삼겹살데이	FALSE
고잔동맛집 한돈삼겹살 행복한돼지집	FALSE
안산 고잔동 맛집 직장인들이 찾는 베스트 장소	FALSE
고잔동배달삼겹살 '미친돼지예대점'에서 직화구이 배달주문 후기!	FALSE
안산 고잔동 맛집 / 안산 회식장소 - 하남돼지집 안산고잔점	FALSE
안산 고잔동 쌈밥맛집 '쌈천하' 쌈이 신선한 곳♡	FALSE
"안산 고잔동 맛집, 일미고깃집"	FALSE
"꺼멍연탄구이_제주생근고기전문점,근고기,연탄구이,고잔동,고잔동맛집,고잔동삼겹살,고잔동연탄구이,고잔동흑돼지,흑돼지근고기,내돈내산"	TRUE
안산고잔동맛집  육회 그리고 삼합보쌈	FALSE
"안산 삼겹살 맛집, 토종한우 한돈세트"	FALSE
삼겹살이 땡기는 날 고잔동 삼부자 왕돌판	FALSE
안산 고잔동 맛집 추천 [신’s 쭈꾸미]	FALSE
[안산맛집] 고잔동 제주도깨비에서 두툼한 고기를 맛보자	FALSE
안산 고잔동 두툼 목살 맛집 북해도식 숯불구이 리가든	FALSE
"고잔동 삼겹살, 고잔동 고기집 추천_하남돼지집 안산고잔점"	FALSE
[안산고잔동맛집] 떡삼겹살&돼지국밥	FALSE
[안산맛집] 엉터리생고기 대신 청춘삼겹살!! 고잔동존맛집/고잔역맛집추천/고잔동무한리필/삼겹살맛집	FALSE
고잔동 고기집 착한고깃집:안산 찐맛집! 정말 맛있게 먹고 왔어요.	TRUE
"안산 고잔동 맛집: 쌈밥전문 쌈천하 , 쌈이 신선한 집"	FALSE
"[고잔동 맛집/와동 맛집] ""내모메좋은쌈밥""에서 맛있는 삼겹살쌈밥을 추천합니다!! /쌈밥 맛집"	FALSE
"고잔동 와인, 숙성고기 전문점 에이지너리14"	FALSE
안산 고잔동 맛집 재방문한 무한리필 장어집 명품장어	FALSE
안산 고잔동 무한리필 맛집 추천 [국가대표고기집 고잔점]	FALSE
안산 삼부자왕돌판! 고잔동 삼겹살 추천해요!	FALSE
안산 한대앞역 맛집 | 삼곱식당 | 삼겹살 찐 맛집 ??	FALSE
안산고잔동맛집 안산삼겹살맛집 안산맛집 행복한돼지집 안산돼지고기 안산삽겹살 안산데이트	FALSE
고잔동 샐러드 맛집 <오늘샐러드> : 샐러드가 삼겹살보다 맛있어요 :D	FALSE
"안산 고잔동 맛집 , 고기파이터 ~"	FALSE
삼부자왕돌판 고잔동삼겹살 고잔신도시맛집	FALSE
정직한생고기 - 맛있는 안산 고잔동 삼겹살 소갈비	FALSE
[안산 고잔동]맛찬들 왕소금구이/삼겹살 맛집/구워주는 고깃집/육즙 풍부하고 식감좋은 고기/명이나물과 구운떡까지	FALSE
"[안산고잔동맛집] 육즙 가득한 두툼한 목살이 맛있는, 북해도식 숯불구이 리가든"	FALSE
[안산 고잔동] 고기 싸롱 고잔점 방문 후기(광고 x)/ 안산 삼겹살 무한리필/ 고잔동 고기 맛집	FALSE
"안산 고잔동 파스타 맛집 ""포크너"""	FALSE
안산 고잔동 맛집 장인소곱창 추천해요	FALSE
안산 고잔동 맛집 국가대표무한리필 고기집	FALSE
안산 고잔동 막창 맛집 술이 쭉쭉 들어가요	FALSE
[안산고잔동] 본삼겹이 맛있는 제주도깨비	FALSE
삼부자왕돌판 :: 고잔동삼겹살 먹고 왔어요!	FALSE
고잔동맛집 돈카츠석 짱맛!	FALSE
안산 삼겹살 맛집 하남돼지집 안산고잔점	FALSE
"(안산 고잔동 파스타 스테이크 맛집 보통날엔 파스타) 목살스테이크1, 상하이파스타(게살)1, 자몽에이드1, 망고에이드1"	FALSE
안산 고잔동 맛집 제주연탄고기전문점  제주돈고집에 다녀왔어요.	FALSE
고잔동삼겹살 삼부자 왕돌판 : 넓은 돌판에 손으로 직접 썰은 한돈 인증 삼겹살이 대표 메뉴!	FALSE
안산 데이트 고잔동 맛집 휘니치로	FALSE
"안산 고잔동 맛집, 육해공 생고기 막회포자 ~ 그래, 이맛이야"	FALSE
안산 중앙동 착한돼지(안산 삼겹살 맛집/안산 중앙동 삼겹살/중앙동 삼겹살/안산 무한리필/중앙동 무한리필/고잔동 삼겹살/고잔동 삼겹살 무한리필/중앙동 삼겹살 무한리필)	FALSE
"안산 고잔동 맛집 고기싸롱 :: 12,900원으로 즐기는 무한리필 고기뷔폐"	FALSE
"[안산] 고잔동 참치거리 참치맛집 ""오사카참치"""	FALSE
안산 고잔동 맛집 고기 무한리필 / 고기싸롱	FALSE
"[맛집추천] 나만 알고 싶은 '고잔 일미고깃집' (+위치, 메뉴, 고잔동맛집추천)"	FALSE
(안산 고잔동맛집 스시와라참치) 스페셜특초밥 2인	FALSE
"[안산 고잔동 맛집] 모든 고기가 다 부드럽고 맛있는 ""짚탄갈비"" (feat. 토마호크)"	FALSE
안산 고잔동 삼부자 왕 돌판에서 삼겹살 한 상	FALSE
고잔동 고기 무한리필 맛집 국가대표고기집 _ 고기는 언제나 든든하게	FALSE
[안산맛집] 안산 고잔신도시 맛집/안산 고잔동 맛집 원조마포생갈비	FALSE
안산 고잔동 맛집 [짚탄갈비 안산고잔점] 오픈하다!	FALSE
안산고잔동맛집 : 삼겹살 돼지고기 맛있는곳 일미고깃집 : 회식장소추천	FALSE
숯불갈비 전문점 짚탄갈비 [안산 고잔동 맛집/술집 추천]	FALSE
안산 삼겹살 맛집 전복 품은 황금돼지 아싸~ 활전복!	FALSE
안산 고잔동 신도시 모임하기 좋은 맛집 구가네 고깃간 갈매기살 삼겹살맛집 추천	FALSE
[ 안산고잔동맛집 / 안산양꼬치 / 안산친우양꼬치] 안산에서 양꼬치는 '친우양꼬치'	FALSE
고잔동무한리필 고잔동맛집 국가대표고기집 안산점	FALSE
안산 삼겹살 맛집 무한리필 중앙동 왕손통돼지집	FALSE
"쌈밥하면~~ 고잔동맛집 , 쌈천하가 최고 ^^"	FALSE
인천논현역맛집 고잔동맛집 소소한쌈 뉴코아인천논현점	FALSE
안산 고잔동 맛집 하남돼지집 고잔점 내돈내먹 솔직후기	FALSE
[안산] 고잔동 맛집!!! 육즙이 살아있는 고깃집! '제주도깨비'	FALSE
안산 맛집 :: 하남돼지집 고잔점 /안산 고잔동 맛집/안산갈매기맛집	FALSE
고잔동 해우돈-직장인들의 맛집	FALSE
안산 고잔동 맛집 <짚탄갈비 안산고잔점>::고잔동 존맛탱 고깃집 내돈내산 후기_재방문의사200%	FALSE
안산 중앙동 삼겹살&항정살 맛집 - 제주통돼지 퇴근후 행복의 맛!!	FALSE
<안산 고잔동 맛집> 육해공 포차	FALSE
"안산 고잔동소곱창맛집, 장인소곱창 (중앙역, 고잔역 인근)"	FALSE
"[안산 고잔동] 야외에서도 먹을수 있는 삼겹살& 토마호크 숄더랙 ""방철쌈"""	FALSE
"(안산회식장소, 안산삼겹살맛집) 오래간만에 갔더니 더 맛있어진 하남돼지 안산고잔점"	FALSE
((안산))고잔동맛집 청춘낙곱새-리얼후기	FALSE
고잔동 맛집/ 먹물 오징어집/ 오삼불고기	FALSE
[안산고잔동맛집] 몸보신하기 좋은 안산보양식 천지염소탕!!	FALSE
고잔동 삼겹살 제주산고기 제주돈고집 방문후기	FALSE
안산 청국장 맛집 고잔동 강원도 청국장 - 비지찌개 / 청국장 / 오삼불고기	FALSE
[안산] 고잔동 맛집!! 연탄불에 구워 맛있는 제주돼지! '꺼멍연탄구이'	FALSE
안산 맛집 껍데기가 서비스인 고잔동 고기집 왕주먹에 다녀왔어요.	FALSE
고잔동맛집::화정숯불갈비에 다녀왔어요!	FALSE
"안산 고잔동 맛집, 돼지고기의 진리 '하남돼지집'"	FALSE
??안산 고잔동 맛집 하남돼지집 고잔점 내가 왕이 된 상인가????	FALSE
[맛집추천]안산 고잔동 자연채월남쌈	FALSE
국가대표고기집  안산점 무한리필 고잔동 가성비 맛집!	FALSE
<고잔동맛집> 상범이네 가정식백반	FALSE
안산 고잔동 맛집	FALSE
안산 고잔동 고깃집 토종한우 여기 레알 찐맛집	FALSE
"인천논현 삼겹살맛집 ""따띠삼겹"" 테이크아웃해가셔요~?"	FALSE
안산맛집 :: 고기 못굽는사람 여기모여라~ 고잔동고기맛집 <왕주먹>	FALSE
안산 맛집 고잔동 맛집::제주돈고집 통통한 제주 생오겹살	FALSE
[안산고잔동맛집] 솥뚜껑 삼겹살 마루야끼	FALSE
안산 솥뚜껑삼겹살 맛집 마루야끼 에서 점심으로 넷이7인분 ㅋㅋ	FALSE
안산 고잔동 돼지고기 삼겹살 맛집 추천 분위기있는 신도시 펍 술집	FALSE
안산 고잔동 맛집 김제삼  코다리조림 매콤하니 입맛을 사로잡네요~	FALSE
고잔동 술집 안주가 정말 맛있는 응답하라 비어썸! 같이가게 이벤트로 시식메뉴까지!	FALSE
고잔동 맛집 안산 해가횟집 회식장소 괜찮네	FALSE
안산고잔동맛집-왕십리할매곱창막창구이에서 맛있는 소곱창먹기!	FALSE
안산 고잔동 맛집 고기가 맛있는 토종한우 정육식당에서	FALSE
(안산 삼겹살 맛집) 무엇보다 삼겹살 맛있어서 또 간 맛찬들	FALSE
고잔동 소고기 맛집 진원소우 - 소고기 무한리필 / LA갈비 맛집	FALSE
안산 고잔동 고잔신도시 맛집 : 안산조개창고	FALSE
"[안산 맛집] 고잔동에서 제주도의 맛을 느끼고 싶다면? ""제주삼육돈고잔점"" (꿀팁까지)"	TRUE
"안산 고잔동, 본심"	FALSE
안산고잔동맛집소개~신도시 고기집삼겹살전문식당 화통삼추천	FALSE
안산 고잔동 이자카야 사이쵸쇼우지 심야식당 생각나는 일본풍 술집	FALSE
안산 고잔동 고기맛집 [본심] 소개팅 장소로 추천 분위기 맛집	FALSE
초벌구이 해주는 고잔동 제주산 생고기 맛집 ::: 제주삼육돈????	FALSE
[안산 고잔동맛집] 북해도식 숯불구이 맛집 “리가든 고잔점”	FALSE
[안산맛집] 제주도깨비 :: 고잔동 맛집/고잔신도시맛집/안산신도시맛집/안산고잔동맛집/25시광장맛집/삼겹살맛집	FALSE
[안산고잔동 그릴룸] 직접 구워주는 고기맛집 그릴룸	FALSE
"안산고잔동맛집 추천! 안산무한리필 고기집, 고기싸롱"	FALSE
고잔동 삼겹살은 하남돼지집 인정인정	FALSE
안산 고잔동맛집/와동맛집/우리동네 숨은맛집 내모메좋은쌈밥집	TRUE
안산곱창 / 안산곱창맛집 창창창 / 안산고잔동맛집추천	TRUE
"고잔동맛집 ""국가대표고기집 고잔점"" 가성비최고"	FALSE
[후기] 안산 고잔동 고기 맛집 제주삼육돈	FALSE
안산 고잔동:) 삼겹살과 쌈채소가 맛있는 삼부자왕돌판구이!	FALSE
[안산 고잔동 맛집] 퀄리티 좋은 고기! 안산무한리필 맛집 '고기싸롱'	FALSE
"안산 고잔동 육회 & 연어 맛집, 하누본 육회포차 고잔점"	FALSE
[안산 고잔동 맛집] 점심 백반 맛집 생갈비 김치찌개!	FALSE
[안산고잔동맛집] 부드럽소	FALSE
"안산 고잔동 고기집 , 아리화 맛집 탐방하기 좋은곳"	FALSE
안산 고잔동 맛집 호프 술집 와이키키 골뱅이무침쌈 계란말이 카스병맥 재방문	FALSE
안산 고기집 왕주먹 새로 찾은 고잔동 고기집 삼겹살 목살은 물론이고 껍데기까지 최고!!	FALSE
안산 고잔신도시 맛집 삼겹살이 맛있는 한상생고기	FALSE
안산 고잔동 맛집 고잔동 회식장소 추천 '왕주먹'	FALSE
안산삼겹살맛집 고기구워주는 하남돼지집 안산고잔점	FALSE
안산 고잔동 맛집 최애 고깃집 왕주먹	FALSE
안산 고잔동 횟집 육해공생고기 막회포차에서  회와 고기를 한번에~ 순삭하고 왔어요!!!	FALSE
"안산고잔동맛집 ""고기싸롱"" 안산무한리필!!"	FALSE
안산 고잔동 맛집 행복한돼지집	FALSE
안산고잔동맛집:: 하남돼지집 안산고잔점	FALSE
안산 고잔동 맛집 - 안산 고기집 반반한덤구이 고잔점에서 푸짐하게 먹었어요~	FALSE
[고잔동맛집]일본식느낌에 굽는 재미가 있는 고깃집 #야끼화로	FALSE
안산 고잔동 맛집 뒷고기 먹고 천국가세효	FALSE
"안산 고잔동 안산그집쭈꾸미 : 쭈삼한판(보통매운맛)1, 공기밥1, 돈까스1"	TRUE
안산 고기집 왕주먹 주먹고기 껍데기가 맛있는 고잔동 맛집	FALSE
안산 고잔동 고잔신도시 제주도깨비 맛집인거양? 삼겹살과 한라산이 생각날때 분위기 좋은 고깃집	FALSE
안산맛집/돼지갈비맛집/삼겹살맛집/가야농원/그린포그/가야농원메뉴/고잔동고기집	FALSE
"안산 고잔동맛집, 연탄불에 구워먹는 고깃집 '꺼멍'"	FALSE
안산 고잔동 중앙역 냉동 삼겹살 맛집 - 서울회관	FALSE
국민돼지 :: 안산 고잔동 고잔신도시 삼겹살	FALSE
고잔동 맛집 : 고잔일미	FALSE
안산 고잔동 술집 '한량' 다녀왔어요~ 갬성 인테리어까지 추천!	TRUE
고잔동맛집 고기싸롱 무한리필 가성비대박!	FALSE
"안산 고잔동 맛집, 육즙대박 고기를 먹고 싶을땐 ""하남돼지집"""	FALSE
((안산))고잔동맛집 상황돈-리얼후기	FALSE
안산 고잔동 맛집 아는 사람은 다 안다는 먹물오징어	FALSE
안산 고잔동 맛집 ‘상황돈’	FALSE
안산 고잔동 고깃집맛집 하남돼지집 엄마랑 술한잔 데이트 ~ 데이뚜~	FALSE
안산 고잔동 맛집 돈까스 전문 카츠혼칸	FALSE
안산고잔동맛집! 영월애곤드레 한정식 맛집 왕추천해요 :)	FALSE
안산 고잔동 맛집~삼겹살집[화통삼]	FALSE
[안산 삼겹살 맛집] 안산 회식 장소로 추천해요	FALSE
[안산 고잔동 고기] 토종한우 정육식당 소고기 맛집	FALSE
별빛양꼬치_안산 고잔동 맛집	FALSE
매일매일 먹고픈 고잔동 맛집 :) 매일고기집	FALSE
경기 안산 고잔동맛집/신도시맛집 :: 공룡고기	FALSE
"[안산 고잔동] 입안에서 샤르르 녹는 소고기 맛집, 부드럽소"	FALSE
안산 고잔동 맛집 황제해물보쌈 수육+문어+홍어 삼합	FALSE
고잔동막창 대구허서방숯불생막창 안산점 맛있는 돼지막창 삼겹살 넘나 고소해 :)	FALSE
고잔동 맛집 / 고잔동고기집 : '고잔동 왕주먹'에서 주먹고기 맛보기!	FALSE
"안산 고잔동 맛집 제주도깨비에서 회식장소,데이트장소로 딱!"	FALSE
[안산 맛집] [고잔동 맛집] 화통삼	FALSE
안산 고잔동 맛집 자연별곡 안산점 놀이방 다녀왔어요	FALSE
[안산 고잔동] 돼지맛집 국민돼지	FALSE
"안산 고잔동 맛집, 제주삼육돈 추천드려요!"	FALSE
안산 고잔동 맛집 제주삼육돈 고깃집 무한리필!!	FALSE
<안산맛집/고잔동> 저렴한 돼지고기 '돈뜨락'	FALSE
고잔동쌈밥 쌈천하	FALSE
안산 고잔동 소고기 맛집 토종한우	FALSE
고퀄리티 고기뷔페 깔끔하고 맛있는 안산고잔동맛집 고기싸롱 안산고잔점	FALSE
"[안산/고잔동/고잔신도시/안산문화광장 맛집] 추억의 연탄불고기(메뉴판 有) - 돼지파불고기, 초벌삼겹살"	FALSE
안산 고잔동 맛집 :: 초벌구이로 육즙이 살아있는 행복한돼지집	FALSE
[안산] 하남돼지집 안산고잔점 : 안산 삼겹살 맛집 회식장소로 추천 !	FALSE
"삼겹살 먹으러 고잔동 출동, 춘천명물닭갈비막국수"	FALSE
[고잔동맛집]안산쌈밥집 내모메좋은쌈밥 :D	FALSE
[안산 맛집] 안산 고잔동 맛집 직접 구워주는 고깃집 '하남돼지집'	FALSE
[안산] 고잔동 맛집!! 꼬치에 술 한 잔!! 죽여주는 호수꼬치 '호수꼬치'	FALSE
안산시 고잔동 소갈비 맛집 황소불화로구이!!	FALSE
191130 인천 고잔동 맛집 불쭈꾸미 직화구이 얼얼하게 하판 일번집 인천논현본점	FALSE
남동구 고잔동 맛집-이레한식.	FALSE
안산 고잔동 맛집 제주도깨비 숙성고기가 정말 맛있는 곳 리얼후기	FALSE
고잔동맛집 '고기싸롱 고잔점' 안산무한리필의 신흥강자	FALSE
안산 고잔동 무한리필 고잔동 맛집 국가대표 고깃집 안산점	FALSE
안산 고잔동 맛집 / 10가지 이상 돼지고기가 무한리필인데 가격은 12900원인 고기 맛집 국가대표고기집	FALSE
"고잔신도시 맛집 국민돼지,숙성삼겹살,더덕구이,된장찌개무한"	FALSE
안산 고잔동 맛집 :: 안산무한리필을 찾는다면 고기싸롱 안산고잔점으로 오세요	FALSE
[안산고잔동맛집] 훈이네	FALSE
안산 고잔동 맛집 하남돼지집 언제가도 좋아	FALSE
안산 고잔동 맛집-쭈꾸미철판볶음-쭈꾸미팩토리	FALSE
[안산 고잔동] 홍어한상/안산맛집/고잔동맛집	FALSE
푸짐한 부대찌개 안산 고잔동 남기남 부대찌개 맛집인정^^	FALSE
안산 고잔동 맛집 제주삼육돈 고잔점 무한리필 고기집	FALSE
안산 고잔동 맛집 퀄리티 남다른 제주삼육돈 고잔점	FALSE
"안산 고잔동 맛집, 을용이곱창"	FALSE
안산 맛집 고잔동이자카야 춘 회식장소 추천	TRUE
[안산] 고잔동 고기 맛집!! 키몬찌 추천 꼬오기! 제주흑돼지에 한라산 똑딱!! '탄통제주돼지'	FALSE
고잔동-고잔신도시 삼겹살맛집 - 무한삼겹시대	FALSE
고잔동 상황돈 맛있는 삼겹살에 넘칠듯한 계란찜	FALSE
안산 중앙동 제주산 냉동삼겹살 맛집 총각수퍼 추천	FALSE
인천 남동구 고잔동 맛집[이레한식]	FALSE
[안산맛집] 안산 고잔동 고기집/짚풀 볏짚삼겹살	FALSE
안산 고잔동 맛집 추천 ::: 야끼화로 안산 고잔점	FALSE
안산 고잔동 맛집! '우당' 양념소갈비 맛있는집	FALSE
[안산 맛집] 고잔동 돼지갈비명가 고구려(feat.한우육회)	FALSE
쌈밥이 생각날 땐 고잔동 맛집 쌈천하	FALSE
왕주먹 고잔동맛집 보성녹돈 돼지껍데기+계란찜+청국장+갈치속젓 궁합	FALSE
안산 고잔동 맛집 행복한돼지집	FALSE
"고잔동맛집 추천! 안산 쭈꾸미 맛집, 쭈꾸미도사_쭈꾸미와 대창의 환상적인 만남! (feat. 육전)"	FALSE
"안산 고잔동 급랭삼겹살 서울회관, 삼겹살은 안질려"	FALSE
<안산 고잔동 맛집> 제주 도깨비	FALSE
[안산삼겹살맛집] 고기로 승부하는 맛집_고잔일미 고깃집	FALSE
[고잔역/고잔동/고잔신도시맛집] 화통삼삼겹살	FALSE
[고잔동 맛집 / 회식 장소 추천] 고잔일미 고깃집	FALSE
안산맛집))중앙동맛집/고잔동맛집/문경새재/안산중앙동 문경새재/문경새재삼겹살/	FALSE
"고잔동 숨어있는 낙곱새 맛집 ""88상회"""	FALSE
맛집 : 고잔동-하남돼지집	FALSE
"안산 고잔동 맛집, 왕주먹"	FALSE
"안산 고잔동 맛집 국내산 생삼겹살이 최고인, 삼부자왕돌판"	FALSE
[고잔동맛집]고잔동 행복한돼지집에서 기름칠 하고왔어요:P	FALSE
안산 고잔동 맛집 :: 초벌로 구워 고기가 맛있는 행복한돼지집	FALSE
고잔동 맛집 백팔번집 제주흑돼지전문	FALSE
안산 고잔동 맛집 고기집 연말모임&회식장소 화로야	FALSE
안산 고잔동 불고기맛집 석쇠로770 연탄집 (영업종료)	FALSE
[고잔동 맛집] 안산에서 삼겹살 제일 맛있게 구워주는 곳'하남돼지집' 고잔점	FALSE
[안산맛집] 안산 고잔동 맛집/고잔역맛집/안산무한리필 고기싸롱 고잔점	FALSE
[인천 남동구 맛집.고잔동 맛집] 이레한식	FALSE
"[고잔동 맛집/ 고잔역 맛집] 안산삼겹살무한리필 ""청춘삼겹살"" 무한리필중 갑 식당♬"	TRUE
안산 고잔동 맛집 * (고기원칙) 서비스로 조개탕까지 먹은 고깃집!	FALSE
<안산맛집/고잔동> 보쌈과 냉채족발의 대가 '대가보쌈과 냉채족발'	FALSE
고잔동 맛집 박가네한우곰탕 : 시원한 국물맛이 일품인 한우차돌버섯만두전골 최고!	FALSE
안산 고잔동 맛집 소고기 안부러운 하남돼지집!	TRUE
"안산 고잔동 서울 회관 | 퇴근 후 가는 맛집, 숯불 갈비, 직화 삼겹이 무한리필?? , 사이드 메뉴까지 완벽했답니다????"	TRUE
안산삼겹살맛집::고잔일미 고깃집 솔직리뷰_삼겹살과 와사비의 조화	FALSE
고잔동맛집 '왕주먹' 연탄불에 구워주는 안산고기집!	FALSE
고잔동 맛집 매력이 어디까지야?	FALSE
"안산 고잔동 맛집, 백팔번집"	FALSE
제주삼육돈 고잔점 고퀄! 가성비!  홀딱~ 빠져버려~ 안산	FALSE
안산 고잔동 크로플 맛집 아어커피 와 리가든 식당	FALSE
안산 고잔동 맛집 : 행복한돼지집 에서 갈매기살 찹찹 ♡	FALSE
고잔동맛집 '고기원칙' 찐후기	FALSE
♥ THE ROAST ♥안산고잔동맛집 완전반한 고깃집에서...	FALSE
고잔동 맛집 내가 너 때문에 산다	FALSE
안산고잔동맛집 착한산적 집에서 맛있게 먹자	FALSE
안산고잔동맛집 껍데기클라쓰 먹고왔어요!	FALSE
고잔동 맛집 지금이 제철	FALSE
"고잔신도시 맛집, 안산 고잔동 소고기 가성비 최고"	FALSE
[안산 고잔동맛집] 왕주먹 : 연탄구이 고기 찾으시는 분들께 추천해용!!	FALSE
고잔동 맛집 그냥 입이 떡 벌어짐!	FALSE
안산 고잔동 맛집 고잔동 고기집 '제주도깨비'	FALSE
고잔동맛집 고잔초지숯불갈비 안산맛집추천 고잔동맛집추천 워터맨추천맛집 안산삼겹살맛집추천 안산삼겹살집추천 안산뼈삼겹살 안산신도시맛집추천 안산회식장소추천 우리동네맛집추천	FALSE
[맛집/안산] 국가대표고기집 / 다양한 종류의 고기 무한리필 고잔동맛집	FALSE
"안산 고잔동 맛집, 허서방숯불생막창"	FALSE
"안산 고잔동 맛집 제주도깨비, 회식장소강추"	FALSE
안산 고잔동/중앙역 맛집 명동한우 존맛탱구리??	FALSE
고잔동갈비 1인분으로도 배불리 먹을수있는 가성비갑 명가금돼지	FALSE
"고잔동) 로다윤의 기원 전, 즐겨가던 추억의  고깃집"	TRUE
안산	TRUE
안산 고잔동 퐁듀 삼겹살 구이 맛집 저녁메뉴!	FALSE
"안산삼겹살맛집, 하남돼지집 안산고잔점 : 고기 구워줘서 너무 편해요"	FALSE
"안산 중앙동 냉동삼겹살 맛집, 삼일돌구이"	FALSE
안산 고잔동 맛집 하안돌곱창 엄지척~!	FALSE
고잔동 맛집으로 유명한 안산 쌈밥 @ 쌈천하	FALSE
